abadi: forever; eternity; always; permanently:Tatizo hili sasa ~ this is now a permanent problem
abaki: abacus
abiri: sail; navigate; travel. ()abiria; () abiriana; () abiriwa; ()abirika; () abirisha; forecast; foretell; predict. ()abiria; () abiriana; () abiriwa; ()abirika; () abirisha; learn from experince or incidents. () abiria; () abirika; () abirisha
abudu: worship: ~ Mungu mmojaworship one God. 2 idolize. 3 adore; love: ~ kaziadore work; ~ usingizi adore sleep. ()abudia; ) abudiana; () abudiwa; ()abudika; () abudisha; toy
achia: bequeath; cave in; concede; leave; slip. 2 release from: ~ huru manumit. ()achilia; () achika; () achiana; ()achisha; () achiwa
achwa: be divorced
adabu: good manners; proper behaviour; courtesy; etiquette. (ms) Hana ~ he has no manners; Fanya ~ behave; Tia ~ punish; teach good manners
adamu: Adam
adana: musical instrument resembling a piano
adesi: pea; lentil
adibu: chastise; teach manners to sb. () adibia; () adibiana; () adibiwa; () adibika; () adibisha; decorous; good manners. 2 polite
adidi: count; enumerate. 2 prepare; make ready. () adidia; () adidiana; () adidiwa; () adidika; () adidisha
adili: be impartial/just /righteous; reason. () adilia; () adilika; () adilisha
adimu: scarce; rare; hard to come by:Chakula ni ~ food is scarce
afiki: agree with; concur; correspond to:Wajumbe wame~ pendekezo the members have agreed with the proposal. () afikia; ()afikiana; () afikiwa; () afikika; ()afikisha
agana: make an agreement. 2 exchange farewells. () agania; ()aganika; () aganisha
agano: promise. 2 agreement; contract. Agano
agiza: order; charge; enjoin; prescribe; commission. 2 direct; give instructions. 3 call upon. () agizia; () agizika; () agizana; () agizisha; () agizwa
agizo: order; commission. 2 directive; rescript; instruction; ordinance
aguzi: predictions; prophesies. 2 interpretations of dreams; omen etc. ah! an expression of showing being disturbed or annoyed
ahadi: promise; promises; pledge; oblige; commitment; gage; resolute. (ms) Toa ~make a promise; Vunja ~ break a promise; Timiza ~ keep a promise; death
ahali: wife: ~ zangu my wives. 2 family; kindred; relatives; connexion
ahera: future life after death. 2 paradise
aheri: end; last stage; finish. (ms)Toka awali hadi ~ from beginning to the end. 2 bargain price
ahidi: promise; engage; ahir.i contract; undertake. () ahidia; () ahidiana; () ahidiwa; () ahidika
ahiri: procrastinate. () ahiria; ()ahirika; () ahirisha
aidha: further; moreover; then: wa~ and moreover; and so
ajabu: wonder; uncommon; strangeness; surprising; amazing: Ma~ ya duniathe wonders of the world; marvel; sth unusual. kvextraordinary; stupendous; wonderful: Mtu wa ~a wonderful person. strangely; extraordinarily; too much: Jua ni kali ~ the sun is just too hot
ajali: accident; fate: ~ imemfika na amekufa he met his fate and died; Alifariki kwa ~ ya gari he died in a car accident
ajemi: round flat bread
ajihi: visit. () ajihia; () ajihiana; () ajihiwa; () ajihika; () ajihisha
ajila: urgency; haste; rush
ajili: reasons; cause; sake: Piganakwa ~ ya haki fight in the cause of justice; Kwa ~ ya for the sake of; because of; rush; hurry. () ajilia; ()ajilika; () ajilisha
ajira: employment; work
ajiri: employ; hire; engage; retain. ()ajiri; () ajiriana; ()ajiriwa; ()ajirika; () ajirisha
ajizi: negligence; slackness; laziness. kvnegligent; lazy; slack: Fanya ~ be lazy; be lazy or negligent. () ajizia; () ajizika; () ajizisha
ajuza: very old woman: ~ mkali sana harridan; ~ mtabiri sibyl
akali: a few; a little: ~ ya vitu a few things. in short: Kwa ~ kazi hii itahitaji watu watatu in short this work needs three people
akari: alcoholic drink
akiba: savings; hoard; stock; supply; reserve: ~ ya chakula food reserve; Jeshi la ~reserve army; Weka ~ make a saving
akida: (zamani) head of an army. 2 headman during colonial administration; messenger
akidi: marriage ceremony: Funga ~perform a marriage ceremony; be enough (for); suffice for. 2 falsify; forge; fabricate. 3 complete; finish. ()akidia; () akidika; () akidisha; quorum
akidu: contractor
akika: feast made during the first hair cutting of a child usually when it is eight days old
akiki: prayer said at a funeral service of a child who died before his/her first hair cut; ruby; cornelian; gully
akili: intelligence; intellect; nous; reason; resource; wit; brain; ingenuity: ~ taahiramental retardation; ~ timamu sane
akina: group of people of similar status; sex; interest etc.: ~ mama women; ~ babamen; ~ yakhe common people; ~ sisi the like of us; we
akisi: reflect; reverbarate: Maji ya bwawa yali~ nyumba na miti iliyoizunguka the water of the dam reflected the houses and trees surrounding it. 2 signal; symbolize sth or tell sth:Ukimya wake una~ jambo zito lililompatahis/her silence symbolizes sth bad that befell him/her. () akisia; () akisiana; ()akisiwa; () akisika; () akisisha.-ako kvyour (possessive adjectival akraba root for the second person singular): Mke w~ your wife; Shamba l~ your farm; Matunda ya~ your fruits; Chakula ch~ your food
alama: sign; token; mark; clue; stamp; trace. 2 index: Tia ~ put a mark; ~ ya cheo a sign of one's rank e.g. a badge; a bar etc. 3 marks: Alipata ~ nzuri he got good marks. 4 seal. 5 smudge; speck; splotch. 6 stigma. 7 ali.a vestige
alamu: alarm; a warning sound or signal
alifu: first letter of the Arabic alphabet; write a book. () alifia; ()alifiana; ()alifiwa; () alifika; ()alifisha
alika: explode. () alikia; ()alikiana; () alikika; () alikisha; ()alikwa; invite; bid: Wageni walio~wathe invited guests. 2 advertise. () alikia; ()alikika; () alikana; () alikisha; ()alikwa; seclude sb: ~ mwari keep a maiden in seclusion; ~ msichana au mvulanaseclude a girl or boy especially during initiation
aliki: hang sth; suspend. () alikia; () alikiana; () alikika; () alikisha; () alikwa
alimu: well educated and experienced person
allah: (Waislam) God: ~ u akbar God is great
amali: charm; witchcraft; sorcery; work; act; career; habit
amana: pledge; deposit; gage; trust; security: Weka ~ put in pawn; precious thing
amani: peace
amari: hawser; anchor rope/cable
ambaa: vamoose; skirt past; pass near: ~ huko! get lost. () ambalia; () ambaka; () ambaza
ambao: ambayo which: Mti ~ umeanguka the tree which fell; ambazo which: Wimbo ~ anaimba the song which he is singing
ambia: tell sb sth. 2 bid: Fanya unavyoambiwa do as you are bidden.()ambilia; () ambika; () ambiana; ()ambiwa
ambua: peel off; shed; decorticate; slough off: ~ gome peel off the bark; ~ ngozished skin. 2 profit from something: Safari hii haku~ kitu he didn't profit this time. ()ambulia; () ambuka; () ambuana; ()ambusha; () ambuliwa
ameta: ammeter. (Kng) amfetamini* amphetamine. (Kng)
amiba: amoeba. (Kla)
amidi: make decision; decide. 2 depend on. () amidia; ()amidiana; () amidiwa; () amidika; () amidisha
amili: realize; know. 2 manage; bring about; make. 3 work. () amilia; ()amiliana; () amiliwa; () amilika; ()amilisha
amini: believe. 2 trust; have faith in; put confidence in; entrust. 3 imagine. ()aminia; () aminiana; () aminiwa; ()aminika; () aminisha; sworn friend /relative: Kaka wa ~ a sworn brother
amiri: begin a thing: ~ shule begin a new school. () amiria; () amiriana; () amiriwa; () amirika; () amirisha; commander: ~ jeshi mkuu commander-in-chief
amisa: confine a girl at her first monthly period. () amisia; () amisika; ()amisana; () amisisha; () amiswa
amkia: greet; accost; salute. ()amkiana; () amkiwa; come before: aliwasili usiku wa ~ jana she/he arrived the night before yesterday
ampea: ampere. (Kng)
amsha: awaken sb. 2 arouse; enkindle; rouse; stimulate activate; vivify. chamshakinywanm. amu* taz. ami
amuru: command; order; charge; enjoin; prescribe; direct. () amuria; ()amuriana; () amuriwa; () amurika; () amurisha
anana: one sixteenth of a rupee. (Khi)
anasa: pleasure; enjoyment; sensuality. 2 luxury
andaa: cater; provide; prepare; brew; put in order. () andalia; (tdek) andalika; () andaliana; (tdes) andalisha; ()andaliwa. mwandalizi n m
angua: knock down; throw down. 2 hatch out: ~ mayai hatch out eggs. 3 reduce the size of sth by chopping off the top. (nh) (i) ~ kiliocry suddenly and loudly; burst out in tears. (2) ~ kicheko laugh loudly. () angulia; (tdek) angulika; () anguliana; (tdes) angulisha; () anguliwa
anika: put out to dry; expose to the sun or air: ~ nguo zako hang out your clothes to dry.() anikia; () anikiana; () anikika; () anikisha; () anikwa; shine as though smeared with fat; look greasy.() nang'anikia; ()nang'anikisha. nani who
anisi: gratify; give pleasure to; indulge (in). () anisia; () anisiana; ()anisiwa; () anisika; () anisisha; luxurious; pleasing
ankra: invoice; bill of sale
anuka: stop raining; clear up: Sasa kume~ it has stopped raining and it is clear again. anuai* various
anzia: emanate
aorta: aorta . (Kng)
apiza: curse; damn; imprecate; execrate. () apizia; () apizika; () apizana; ()apizwa
apizo: curse; imprecation
araka: arrack; a distilled liquor usually from aniseed drunk in the Middle East
ardha: job application
ardhi: land; soil
arifu: inform; tell; declare; explain; notice; predicate. () arifia; () arifiana; () arifiwa; () arifika
ariki: essence
arima: (Islam) God the generous
arshi: compensation for causing somebody to bleed; Gods' throne. 2 throne of the ruler
aruba: four
arufu: mane
asadi: lion. 2 hero/ heroine
asali: honey: ~ ya miwa sugarcane syrup; ~ ya nyuki bee honey
asasi: the begining; or the essence of something; institution
asidi: acid: ~ kaboliki carbolic acid. (Kng) asighari small. asilani (hutumika kutilia mkazo kukataa) never; not at all: Sitakwenda kwake ~ I will never go to his place
asili: nucleus; origin; birth; bottom:Gundua ~ ya jambo go to the bottom of the issue. 2 a person's inborn behaviour/ character. 3 essence; genesis; rise; root; source of something. 4 (hesabu) divisor; common factor. (nh) Hana ~ wala fasili he is nothing. 5 fundamental. 6 property; never
asira: war captive; something extracted of its oil; taste and smell. asiria modern; up to
asisi: found; start; commence; begin; establish; plant. () asisia; () asisiana; () asisiwa; () asisika; ()
asiya: a portion or part of a thing; remainder. 2 symptoms
asusa: (kwa chakula) bites; snack
ateri: artery. (Kng)
atibu: criticize; condemn. () atibia; () atibiana; () atibiwa; () atibika; () atibisha
atika: transplant. () atikia; ()atikiana; () atikika; () atikisha; ()atikwa
atili: waste time: Wakati ni mali si vizuri kuu~ time is money it is not proper to waste it. () atilia; () atiliana; ()atiliwa; () atilika; () atilisha
atomu: atom. (Kng)
atuka: retire; relinquish power. ()ng'atukia; () ng'atukika; () ng'atusha
aunsi: ounce. (Kng)
aushi: for life; standing; permanent:Nguo za ~ permanent
aviza: assist. () avizia; () avizika; () avizana; () avizisha; () avizwa
awali: first. 2 origin; cause. 3 above: Kama ilivyosemwa ~ as stated before
awamu: phase
ayali: family
ayami: many: Siku ~ many days
ayari: cheat; rogue; humbug; impostor; knave; tackle; anchor rope
azali: eternal
azima: borrow; lend. () azmamu azimia; () azimiana; () azimana; () azimika; () azimisha; ()azimwa; charm; amulet
azimu: prepare a charm or talisman.() azimia; () azimiana; () azimika; (() azimisha. () azimwa; decide; intend premeditate; resoleve. () azimia; () azimiana; ()azimiwa; () azimika; () azimisha; () azimwa
aziri: disrespect; disgrace; degrade; disparage. () aziria; ()aziriana; ()aziriwa; () azirika; () azirisha
azizi: valuable thing; something rare; souvenir; rarity; treasure; pia
babia: fumble; beat about the bush. ()babilia; () babika; () babiana; ()babisha; () babiwa
babua: scald; peal off skin as with fire; hot water or illness. 2 char superficially; singe. 3 (colloq) slap; box someone's ears. () babulia; () babuliwa; () babuka; () babuana; () babusha
bacha: shelf in a wall
bafta: calico; lawn
bagua: separate. 2 discriminate against; segregate. () bagulia; (tdek) bagulika; () baguliwa; () baguana; ()bagusha
bahau: fool; idiot; imbecile
baidi: far; distant: Anakaa ~ na hapa he lives far from here. unrelated: Huyu si ndugu yetu; ni mtu ~ he is unrelated to us
baini: realize; recognize: Haku~ jambo hili mapema she didn't realize this fact early enough. () bainia; () bainiana; ()bainiwa; () bainika; () bainisha. bainifu evident; distinguishable; recognizable:Sifa ~ distinctive features
bairi: camel
baiti: house
bajia: cake of ground lentils and pepper. (Khi)
bakaa: remains; remnant. 2 (pesa) balance
bakua: take away by force; rob. 2 strike: Alim~ makofi he slapped him. ()bakulia; () bakuliwa; () bakuka; ()bakuana; () bakusha
balaa: calamity; plague; grief; incubus; misfortune
balbu: bulb. (Kng)
balia: calamity; misfortune
bamba: arrest; apprehend; seize; (si rasmi) nab. 2 block; clog: Waandamanaji wali~ barabara nzima the protestors clogged the street. () bambia; () bambika; ()bambana; () bambwa; (metali; bati) sheet; slab; slat. 2 flat thin piece of anything: ~ la chumaarmour plate; ~la kisu blade of a knife. 3 bumper. (mt) ~ ni la waume hakuna ~ la mumethere is a counsel of men but never of one man. bambam precisely. (ms) Mambo ~ everything is O.K
bambo: grooved pointed iron instrument used for drawing samples of grain from a sack. 2 walking-stick; type of palm leaves used for making mats; baskets etc. 2 basket made from palm leaves
bamia: okra; lady's fingers
banda: shed; barrack; barn; hut; hovel: ~ la farasi stable; ~ la ndege air shed; ~ la gari garage; ~ la kuku poultry yard. kibandanm
bandi: tack; baste: Piga ~ baste; tack
bandu: splinters from wood/log/tree
bangi: bhang; hashish; Indian hemp; marijuana. (Kaj)
bango: stem of a coconut leaf; placard; poster; hoarding; mud guard (of a car; motor cycle); board: Jalidi kwa ~ bind in cloth boards
bania: be mean; spare; skimp; be frugal (in the negative sense). () banika; ()baniana; () banisha; () baniwa
banja: crack; break; split (nuts; firewood etc). 2 strike. 3 (ms) bark up the wrong tree. () banjia; () banjika; () banjana; () banjisha; () banjwa
banjo: banjo. (Kng)
banki: (hasa Kenya) taz. benki
banua: unfasten; release (pressure); loosen. () banulia; () banuliana; ()banuka; () banusha
banza: hide (on a limited space): Ji~squeeze oneself (in a limited space). () banzia; () banzika; () banzana; () banzisha; () banzwa
barua: letter; epistle; note: ~ za ndege air mail; ~ ndogo chit
basha: (mchezo wa batili; male homosexual; sodomite; bugger; (matusi) sod
basua: anxiety; confusion of mind
batli: log book
batua: toddle; waddle. () batulia; () batuka; () batusha
baura: anchor with two flukes. (Kng) bawa pia
bechi: batch. (Kng)
bedui: bedouin; ruthless person
bekua: keep off; ward off: ~ nzi keep off flies. 2 counteract; hit back; receive and return a blow/ball: Aliu~ mpira he hit back the ball. 3 knock off overflowing contents from a full measure: ~ mchele katika pishi knock off the overflowing rice from a full measure. ()bekulia; () bekuliwa; () bekuka; ()bekuana; () bekusha; grab; seize. () bekulia; () bekuliwa; () bekuka; ()bekuana; () bekusha. belele excessively; plenty; abundantly
bemba: pry; wheedle. 2 coax; cajole; entice; coquette; philander; wheedle; allure; seduce. () bembea; () bembeka; ()bembana; () bembesha; () bembwa
bembe: foodstuffs sent to an individual as a present. bembe2 skittish
bendi: band: ~ ya matarumbetabrass band. (Kng)
benki: bank: ~ ya Biashara Bank of Commerce; ~ Kuu Central Bank; ~ ya DuniaWorld Bank; ~ ya damu blood bank. (Kng)
benua: make sth protrude or bulge out or stick out: ~ kifua stick out the chest. ()benulia; () benuka; () benusha; ()benuliwa
bereu: tar; pitch. 2 oil used to protect a vessel from leaking. (Kre)
betri: battery. (Kng)
betua: (mpira) cut; punt; slice; snick. () betulia; () betuliwa; () betuka; () betuana; () betusha
bidaa: innovation
bidii: effort; struggle; activity; devotion; zest; endeavour: Ana~ kubwa katika kazi yake he puts much effort in his work: Fanya ~ struggle; work hard
bilda: Sagittarius
bildi: plummet; sinker. 2 the weight of a clock
binda: okra; lady's fingers. bindo pia
binti: daughter; young lady; miss; girl
binua: protrude. () binulia; ()binuliwa; () binuka; () binuana; ()binusha
binya: pinch; squeeze; tweak; nip; constrict. () binyia; () binyika; ()binyana; () binyisha; () binywa. binzari pia
bisha: knock at the door. () bishia; () bishika; () bishana; bobe.a () bishwa; defy; disobey; demur; argue; impugn. () bishia; () bishika; ()bishana; () bishwa; (kb) lead to the direction of wind. () bishia; () bishika; () bishana; ()bishwa
blabu: blurb. (Kng) blanketi* pia
bleza: blazer. (Kng)
bloku: block. (Kng)
blowa: blower. (Kng)
bobea: immerse; indulge: ~ bobo katika ulevi be immersed/indulged in heavy drinking. 2 specialize: Ame ~ katika uwanja wa isimu he specializes in linguistics. () bobelea; () bobeka; () bobesha
bobwe: mixture of various types of small fish
bodwe: marrow
boflo: loaf (of bread)
bofya: press: ~ kengele press the bell. () bofyea; () bofyeka; () bofyana; () bofyesha; () bofywa
bojia: tip toe. () bojika; ()bojiana; () bojisha; () bojiwa
bokoa: enter; appear. () bokolea; (tdek) bokoleka; (tdes) bokolesha; ()bokoza; get bumper harvest. () bokolea; () bokoka; () bokosha. bomo.a
boksi: box; (US) crib. (Kng) boksiti* bauxite. (Kng)
bolti: bolt. (Kng)
bomba: pipe: ~ la moshichimney; ~ la kupulizia sprayer; ~ la maji water tap; conduit. (ms) ~ loud speaker; radio
bombo: pair of shorts; a long-tailed male bird with black and white colour; sniffles
bomla: wild lizard
bomoa: demolish; destroy; ruin; batter down; spoil. bomoko ()bomolea; () bomolewa; ()bomoka; () bomoana; () bomosha
bonde: valley; hollow; dean; dell; depression
bonga: bore a hole: Mahindi yamebongwa na dumizi maize has been bored by the meal bugs. () bongea; () bongeka; () bongana; () bongesha; () bongwa
bonge: roundish lump; ball; clod; big; huge: ~la mtu a huge person; ~ la gari a big nice car; ~ la matope ball of mud. bongo1 pia
bongo: bongo drum. (Kng) bong'
breki: brake: ~ za upepo air brake. (Kng); break; recess. (Kng)
breli: braille. (Kng)
briji: (gita) bridge. (Kng)
bucha: butcher. 2 butcher's shop. (Kng)
budaa: flour balls in porridge; make flour balls. () budalia; () budaliwa; () budaika; ()budaisha
bufuu: empty shell: ~ la kichwaskull; ~ la nazi an empty coconut shell
bugia: gulp. () bugiliza; ()bugika; () bugisha/bugiza; () bugiwa
bujua: remove the kernel of a fruit; take off the stone of a fruit. () bujuia; ()bujuliwa; () bujuika; () bujuisha
bukua: swot (for sth); read intensively in preparation for examinations. () bukulia; (tdes) bukulisha; () bukuka; reveal a secret; scandal or wrong doing. () bukulia; () bukuka; () bukusha. bumu
buluu: & blue; azure. (Kng)
bumba: swarm (of bees); lump. 2 packet; plug; small parcel; (tumbaku) roll. 3 collection of things or insects: ~ la nyukicollection of bees
bumia: beam forming a stern post of a dhow fastened to the keel; and carrying the rudder-post
bunda: bale; bundle; pack; ream: ~ la noti a bundle of banknotes; ~ la katani a bale of sisal; ~ la karatasi a bundle/ream of paper
bundi: owl; night bird; bad omens
bunga: fool; simpleton. foolish; silly
bunge: Parliament; National Assembly: (Kmw; Kgo)
bungo: fruit with sap like Indian rubber. bungo 2 beetle; small bowl. bungu pia
bunju: poisonous fish of diodon (globe fish) kind; taz. bungu
bunta: slipway; landing stage. 2 ship building yard; dock; jetty
bunzi: maize cob
buraa: forgiveness of obligation; debt or dowry
burai: forgive; exculpate; exonerate; give up or renounce a claim; let off payment:Mwanamke ali~ mahari yake the woman gave up her claims to dowry. () buraia; () buraiwa; () buraika; ()buraisha
busha: elephantiasis of the scrotum
bushi: bush. (Kng)
butua: make blunt; cut off the end. 2 (mpira) kick wildly. () butulia; ()butuliwa; () butuka; () butuana; ()butusha
bwaga: win a game; spill; throw down:~ mzigo throw down a load (from one's head/shoulder); ~ moyo rest the mind; ~ matusilet off a volley of abuse. () bwagia; ()bwagika; () bwagana; () bwagisha; ()bwagwa
bwalo: auditorium; hall: ~ la dansi ballroom
bwana: Mr; Sir; husband: ~ harusi bridegroom; ~ mkubwa used to show respect; ~ shamba agricultural officer. bwana2 hey!; (dini) lord
bwata: blather; jabber; prate about. () bwatia; () bwatika; () bwatana; () bwatisha; () bwatwa; break something by dropping it:~ kikombe break a cup by dropping it. ()bwatia; () bwatika; () bwatana; ()bwatisha; () bwatwa
bwawa: dam; pool; quagmire; reservoir; pond: ~ la kuogelea swimming pool; ~ la samaki fish pond
bwege: good for nothing; simpleton; oaf; lemon; (si rasmi) jerk
bweka: bark; bay; bow-wow. ()bwekea; () bwekeana; () bwekewa; () bwekeka; () bwekesha
bwela: ma boiler. (Kng)
bweni: dormitory
bweta: small box used to keep small items; compact; pant. () bwetea; ()bweteka; () bwetesha. bwete dormant: Volcano ~ dormant volcano
bwiko: arthritis (of bwimbwi fingers)
chafi: broad black sea chafu dirty; filthy; (nywele) unkempt: Nguo ~ dirty clothes. 2 impure; obscene; bad: Lugha ~ obscene/bad language. 3 crummy
chaga: act/work with renewed vigour. 2 be prevalent; persist. 3 form a habit. ()chagia; () chagika; () chagiza
chago: headboard
chaji: (betri) charge. () chajia; () chajiwa; () chajika; ()chajisha.(Kng); charge (sb with); accuse sb of a crime. (Kng); electrical charge. (Kng)
chaka: clump of trees; thicket; hot season (December to February)
chale: clown; jocker; a sea insect with strong poison; incision (on the human body). chali on the back: Lala ~ lie on the back
chalo: sugarcane farm
chama: party; association; guild:~ cha siasa political party: ~ cha wakulimafarmer's association
chana: slit; tear; separate: ~ nguo tear clothes. 2 comb: ~ nywele comb hair. ()chania; () chanika; () chanisha; ()chanana; () chanwa. (Kaj)
chane: bunch (bananas; grapes); slip of leaf (used for plaiting mats and cords)
chani: sea porcupine; coastal area with shallow water
chano: round wooden tray
chapa: beat; hit; strike; swat; whip. 2 defeat by goals: Wame~wa magoli matatu they were defeated by three goals. (nh)() ~ kazi work hard. (2) ~ maji drink excessively. (3) ~ miguu walk; mark-time. () chapia; () chapika; () chapana; () chapisha; () chapwa; brand; trade mark; printer's type. 2 drawing; decoration; design. 3 photoprint. chap.a; print (by using a printing machine): ~ kitabu print a book: ~ vibayamisprint. 2 type. () chapia; () chapiana; () chapika; () chapisha; () chapwa. (Khi)
charo: caravan; company of travellers
chata: make sizzling sound (as of termites). 2 be happy
chati: chart. (Kng)
chatu: python
chawa: louse
chawe: coral-rag
chawu: pit used for burying coconut husks
chaza: oyster. (Kaj)
chazi: liane (cissus rotundifolia)
chazo: sucker-fish (used as a bait)
chega: shave off; cut the hair. 2 harvest cereal. () chegea; () chegeka; () chegana; () chegesha; () chegwa; bang
cheka: laugh: ~ kidogo kidogo snigger.() chekea; () chekeana; () chekeka; ()chekana; () chekesha; () chekwa.cheshi
cheko: kich; laughter. chekwa pia chekwachekwa plenty; in abundance; full
chema: anything good; person of outstanding character. (mt) () ~ hakidumu a good thing does not last long; (2) ~ chajiuza; kibaya chajitembeza a good wine needs no bush
chepe: person who is inconsiderate; ill-bred and mannerless. 2 clown; jester. chepe2 arch. chepechepe sodden; soggy. uchepechepenm
chete: market day. 2 market
cheti: certificate: ~ cha ualimuteacher's certificate. 2 note; chit; record card: ~ cha daktari prescription note; ~ cha kuthibitisha afya bill of health
cheua: eructate; belch: Mtoto ame~ maziwa the child has belched. 2 ruminate; chew the cud: Wanyama wanao~ ruminant animals. () cheulia; () cheuliwa; ()cheuka; () cheusha
chewa: (salamu ya asubuhi) good morning; (baharini) morning easterly winds; giant rock-cod fish: Ana kinywa kama ~ he/she has a large mouth. chewale without much effort; easily
cheza: play. ~ mpira play football; ~ na mtoto play with a child. 2 dally with sth; waste time: Acha ~ na wakati stop wasting your time. 3 dance (to the tune of drums; music etc). 4 shiver (because of fever; illness): Mwili wote unam~ the whole body is shivering. 5 be loose; waver; totter:Kitasa kina~ the door-lock is chimbi.a loose. 6 (askari) drill; be drilled: ~ kwata drill. 7 mock sb; make fun of: Usi~e na kisu don't play with a knife. 8 bewitch. (nh) () ~ bangu fight; cause war; (2) ~ kamari gamble. () chezea; () chezeana; () chezeka; ()chezesha; () chezwa
chifu: chief. 2 (Kenya) location officer. (Kng)
chigi: small yellow bird
china: be stale; be overdue: Chakula kime~ the food has gone bad. 2 fail to get the expected; be disappointed; fail to materialize. 3 delay; be late in getting sth: Mwali ame~ the girl has remained single too long. () chinia. china2 simultaneously: Akitabasamu ~ akiliashe/he was laughing and crying simultaneously
chini: on the ground/floor; down:Teremka ~ go down. 2 below (earth; vessel); in a lower place. 3 (ms) genital organs: ~ ya under; below; ~ ya himaya ya Uingereza under the protection of British Govt; ~ ya ulinzi be in custody; chinichini secretely; ~ ya bahari sea bed
chira: harm a child by breaking taboos. () chiria; () chirika; () chirisha; () chirwa; curse
chizi: cheese. (Kng); profligate person; lawless person. 2 crazy person. cho! whole night: Kesha ~ be awake the whole night. cho!2 lo! hey!
choka: be tired; be fatigued; get weary. 2 get bored; be in need of change; lose interest in sth. 3 (vitu) lose strength; stop being useful: Shamba lime~ the farm is no longer productive. () chokea; () chokeka; () chokana; () chokesha; () chokwa; striped snake
choki: liane with yellowish white flowers (strophanthus Kombe)
choma: pierce; stab; cause pain; singe:~ kisu stab with a knife; ~ sindano give an injection. 2 itch (inside the body). 3 burn; roast; toast: ~ mkaa burn charcoal; Nyama ya ~roast meat. 4 produce a burning sensation on sth; hurt: Maneno yake yalini~ his words hurt me.() chomea; () chomeka; () chomana; ()
chomo: iron slag. 2 stab; prick. (ms) ruka ~ dive into water
chopa: scoop out. 2 vend; retail; hawk. () chopea; () chopeana; () chopeka; ()chopesha; () chopwa; luggage or bundle of anything: ~ la kuni a bundle of firewood: ~ la udongo a heap of soil
chora: draw; design; sketch; paint: ~ mstari sambamba hatch; ~ picha katika kitabuillustrate; ~ mstari outline; ~ ovyoovyo scrawl. () chorea; () choreana; () choreka; () chorana; () choresha; () chorwa
chota: scoop up/out; ladle: ~ maji fetch water: () chotea; () choteana; ()choteka; () chotesha; () chotwa. chotonm
choti: wooden fence
choto: something scooped out
choza: secret
chozi: tear; tear drop: Lia ma~weep; cry; sunbird
chuja: filter; purify. 2 squeeze: ~ nazisqueeze coconut; sieve. 3 separate; choose; isolate. () chujia; () chujiana; () chujika; () chujana; () chujisha; () chujwa
chujo: chukuli.a
chuki: hatred; animosity; dium; spite: ~ ya watu misanthropy. chuki morose
chuku: cupping horn: Piga ~ draw blood. 2 overstatement. (nh) Piga ~ exaggerate
chule: white salt water marks on skin
chuma: iron; metal: ~ cha puairon; steel: bamba la ~ a strip of metal. 2 (ms) a weapon such as a pistol or gun: Kofia ya ~helmet; ~ cha kidole cha kupigia gita plectrum; Mavi ya ~ slag; strong person; one who can be dependable; hero; pick; pluck; gather from a tree (flower or fruits). 2 make money; earn: ~ fedhaearn money. () chumia; () chumiana; () chumika; () chumisha; () chumwa
chumo: plucking. 2 produce; yield; profit; gain; income
chumu: good luck
chuna: skin. 2 strip off bark or covering: (nh) () ~ jogoo be circumcised; (2) ~ ngozi have sexual intercourse; (3) ~ uso act without shame. () chunia; () chunika; () chunana; () chunisha; () chunwa
chuni: provocation: Shikilia ~provoke
chupa: bottle: ~ ya chai vaccum flask; thermos; ~ kubwa ndani ya mfuko wa mianzi demijohn; ~ kubwa jar; ~ ya uturi scent bottle; amniotic membrane; waters. (nh) Vunja ~ break the amniotic membrane/waters; jump down across; hop; leap. 2 (nguo) be short. () chupia; () chupika; () chupisha
chupi: underpants; panties; knickers
chura: frog; (mchezo wa watoto) someone who comes last in a play; cause bad omen. 2 do something abnormal. () churia; ()churiana; () churiwa; () churika; () churisha. hwechwe; lavatory cleaner; sewage attendant. churo ill luck; ill omen; misfortune: Mtoto m~a child whose acts may cause ill luck
chusa: harpoon; trident; cause to dislike; offend; put out; disgust. () chusia; () chusika; () chusana; () chusisha; () chuswa. chushi uninspired
chuya: unhusked rice in clean rice/millet
daawa: lawsuit; litigation; legal claim. 2 matters that bring disputes; act of speaking behind someone's back
dagaa: sardines; anchovy. 2 contemptuous person or thing
dagla: a long coat ornamented with gold braid or thread. (Khi)
dahua: repeat uttered words. () dahulia; () dahuana; ()dahuliwa; () dahuka; () dahuana; ()dahusha
daini: dyne. (Kng)
dakia: tiptoe. 2 jump on to a vehicle when in motion. 3 do sth in a hurry. 4 interject. () dakilia; () dakika; () dakiana; () dakiza; () dakiwa
dalia: aromatic yellow powder; used by women for personal adornment. It is also used in preparing a dead body for burial
dalji: (punda/farasi) amble; even pace (neither quickly nor slowly). 2 graceful walk:Kwenda ~ walk gracefully
damka: get up very early in the morning. () damkia; () damkika; () damkisha
dampo: dump. (Kng)
danda: pass over sth. 2 jump on sth in motion (e.g. a vehicle). () dandia; ()dandiana; () dandiwa; () dandika; ()dandisha
danga: white yam. 2 unripe fruit: (nh) ~ la mwana well mannered youngster; a youth; scoop up/out a small quantity:~ maji scoop up water. 2 look for sth scarce. () dangia; () dangika; () dangisha; () dangwa. dang'a bee stings; colostrum
dango: ma target
dansi: dance. (Kng)
danzi: bitter orange
dapia: jump from one tree branch to another as the small black monkey does. ()dapilia; () dapika; () dapiza; ()dapiwa
dasta: duster. (Kng)
datia: stumble along/ around/about; walk boastfully. () datilia; () datika; ()datisha
dekua: bring down with one shot e.g. a bird with a stone; fruit off a tree with a stick. 2 strike suddenly and coarsely. () dekulia; () dekuliwa; () dekuka; ()dekuana; () dekusha
delta: delta. (Kng)
denda: obtain deceitfully; scrounge. () dendea; () dendeka; () dendana; () dendesha; () dendwa; drool; spittle
denge: hair-cut leaving a patch of hair on the top of the head: ~ la mbuzi (a) billy-goat; (b) goat pen built on poles; raised off the ground
dengu: lentils; chick peas. (Kaj)
deski: desk. (Kng)
deste: dish for serving sweetmeat
deuli: cloth for holding a sword to the waist. 2 pall; cloth for covering a bier
dhana: concept; idea; staple; notion; belief: ~ yenye kosa fallacy
dhani: think; surmise; suppose; guess; calculate. () dhania; () dhaniana; () dhaniwa; () dhanika; () dhanisha
dhara: harm; hurt; loss; detriment
dhati: essence; sincerity; resolve; free will: Shukurani za ~ sincere appreciation
dhibu: reinforcement forces
dhidi: dhidi ya contra; against: Vita ~ ya UKIMWI war against AIDS
dhifa: banquet: ~ ya taifa a state banquet
dhiki: distress; oppression. 2 lack of basic needs; difficulty; distress; put in difficulties. ()dhikia; () dhikika; () dhikisha
dhili: lower; set at nought; torture. 2 abase; degrade; humiliate. () dhilia; () dhiliana; () dhiliwa; () dhilika; () dhilisha; shadow
dhima: duty; responsibility; role; obligation; liability. 2 (uhasibu) debt
dhuha: period between sunrise and noon. 2 Moslem prayer of that period
dhuku: taste; try the taste of sth. ()dhukia; () dhukika; () dhukisha
dhuli: weak or suffering person; wretch; disappointment
dhulu: come to light; be discovered; be known. () dhulia; () dhulika; ()dhulisha
dhuru: hurt; damage: Tendo la ~maleficent act. 2 injure: hai~ it is of no harm; it does not matter. () dhuria; () dhuriana; () dhuriwa; () dhurika; () dhurisha
dimba: entrance to women's initiation camp. 2 court for initiation rites. (nh)Fungua/funga ~ open/close an event; recultivated fallow
dinda: stand firm; be firm or taut. 2 have an erection of the penis. () dindia; ()dindiana; () dindiwa; () dindika; ()dindisha
dingi: (sio rasmi) father; old man; boss
dishi: dish. 2 (si rasmi) food. (Kng)
disii: District Commissioner (D.C.). (Kng)
diski: disc; ~ ya muziki music disc; breki za ~ disc brakes. (Kng)
disko: discotheque. (Kng)
divai: wine. (Kfa)
dokoa: filch; snaffle; snatch. 2 bite/break off small portions. () dokolea; () dokoka; () dokoana; () dokoza; () dokowa
donda: lesion; sore; ulcer: ~ ndugu spreading; persistent ulcer
dondo: large tiger cowrie-shell used by tailors to smoothen seams. 2 starch used to give a good surface and of appearance to inferior material; kind of inedible sea crab; size; polishing glue
donea: kiss; peck at. () donelea; () doneka; () doneana; () donesha; () donewa
donge: small round mass; lump; ball: ~ la uzi ball of thread. 2 (damu) clot. 3 (ms) lumpsum (of money); income; salary
donoa: peck; pick bit by bit with the beak; (zeze) thrum. 2 bite bit by bit esp. for fowls/birds. () donolea; () donoka; () donoana; ()donosha; () donowa
dopoa: bore a hole. () dopolea; ()dopoka; () dopoana; () dopoza; ()dopowa
doria: white muslin; organdie. (Khi); security patrol
drama: drama. (Kng)
drili: drill. (Kng)
duara: circle: ~ kamili la umeme complete circuit (of electricity). 2 aureola
dudia: inflate. () dudilia; ()dudika; () dudiana; () dudiza; ()dudiwa
duizo: curse
dumaa: fail to develop fully; be stunted in growth. 2 lack intelligence. () dumalia; () dumaka; () dumana; () dumasha; () dumawa
dumbi: trench (for draining rain water)
dumia: sip esp. during shortage of water. () dumilia; () dumika; () dumisha; () dumiwa
dunda: knock against with force; bounce; dribble: ~ mpira bounce a ball/dribble a ball
dundu: big dried gourd used for carrying & storing water & other liquids; bale; heap of things; scavenger beetle. dunduiz.a
dunga: pierce; bore: ~ sindano inject. () dungia; () dungika; () dungana; () dungisha; () dungwa; covered bamboo basket; witchcraft; sorcery; magic.(nh) Piga ~ bewitch
dunge: unripe cashew apple
dungu: watchtower; tribune; (eropleni) cockpit
dunia: (sayari) earth; world. 2 life:Fariki ~ die
duwaa: be dumbfounded; be speechless because of astonishment. () duwalia; () duwalika; ()
edaha: offering; sacrifice
edeni: Eden; Garden of Eden; paradise. (Kng)
edita: editor. Kng) ee! expression used for calling sb in a contemptuous way. 2 O!: ~ Mungu O God; ~ Bwana O Lord!
egama: be in a leaning; resting or reclining position. () egamia; () egamika; () egamisha
egema: come or be close to sth: (nh) ~ pwani walk alongside sea shore. 2 confront sb. 3 depend on. () egemea; () egemeana; () egemeka; () egemeza; () egemwa
eleka: carry (a child) on the back. ()elekea; () elekeana; () elekeka; ()elekesha
elewa: understand; know; comprehend:~ vibaya misconceive; misconstrue; misunderstand. () elewea; () eleweka; () elewana; () elewesha
eleza: elucidate; describe; explain; brief:~ kwa mifano illustrate; ~ wazi clarify; explicate; expound; ~ jambo jumlajumla generalize. ()elezea; () elezeka; () elezana; ()elezwa
elimu: education; knowledge: ~ ya imani dogma; ~ ya chanzo cha magonjwa etiology; ~ ya kutambua tabia physiognomy; ~ ya tabia ya hewa pneumatics; ~ya viungo bandia prosthesis
embwe: kind of glue: ~ ya mbuyu sticky sap of a baobab tree
endea: approach sb; go to sb:Nilimw~ Mwalimu I went to see the teacher. 2 go for (by; in): ~ maji go for (to fetch) water; ~ baiskeli go for a bicycle. () endelea; ()endeka; () endeana; () endesha; )endewa
enema: enema. (Kng)
eneza: deploy; disseminate; spread; extend over; diffuse; infect: ~ habari spread/ disseminate the news. () enezea; ()enezeka; () enezwa
engua: skim; take scum off water / milk etc. () engulia; () enguliana; ()enguliwa; () enguka; () enguana; ()engusha. enhee! pia ehee! yes; okay; aha! -enu your; yours. -enye having; possessing; with: ~ maliwealthy; ~ kibiongo with a hump; hump backed; ~ maji watery; ~ ari earnest. -enyewe self; actual: Mtu mw~ the man himself; Mimi mw~ I myself; Habari z ~ the actual news. 2 owner; concerned: Huyu ndiye mw~ this is the owner/the one concerned. enyi! you there! (plural)
epuka: avoid; escape; refrain; distance oneself from: ~ kwa hila elude. () epukia; () epukika; () epukana; () epukisha; () epukwa
etuka: be astonished; be surprised. ()etukia; () etukika; () etukisha
ezeka: (nyumba) roof; thatch. (ms) ~ makofi blow; box ears. () ezekea; ()ezekeana; () ezekewa; () ezekeka; () ezekesha; () ezekwa
fagia: sweep. 2 finish completely; polish off. () fagilia; () fagika; ()fagiana; () fagisha; () fagiwa
faida: interest; profit; gain; benefit. 2 advantage; blessing; treasure; asset: ~ kubwaprivilege
faidi: profit; benefit. 2 enjoy. 3 amuse oneself. 4 advantage. () faidia; () faidiana; () faidiwa; () faidika; () faidisha
faili: file (correspondence; records etc). () failia; () failiana; () failiwa; () failika; () failisha. (Kng); file (for keeping paper). (Kng)
faini: fine. () fainia; ()fainiana; () fainiwa; () fainika; ()fainisha. (Kng); fine. (Kng)
falka: hold (of a vessel)
fanya: do (sth); act; commit; work. 2 make; render; manufacture. 3 hold. 4 make sth happen. 5 manipulate: ~ doria patrol; ~ embamba attenuate; ~ gwaride parade; ~ kiinimacho juggle; ~ kosa perpetrate; ~ mzahafalter with; ~ ufidhuli hector; ~ ukahabaprostitute; ~ upya recast; ~ urafiki befriend; ~ wakfu hallow; ~ fujo cause trouble; ~ alie cause (sb) to cry. () fanyia; () fanyika; () fanyana; () fanyiza; fanyisha; ()fanywa
farao: pharaoh. (Kng)
fashi: chapter
fauka: ~ ya apart from that; besides
faulu: be successful; achieve. 2 pass an examination. () faulia; () faulika; () faulisha
fedha: silver. 2 money; lucre; (in general) brass; coin: ~ taslimu cash. 3 capital; cover. 4 finances
feuli: hold (of a ship; dhow etc.)
ficha: hide (from); conceal; choke; bury; disguise. 2 refuse/decline to show; explain; expose or reveal. 3 hold. () fichia; () fichika; () fichana; () fichisha; ficham.a () fichwa
ficho: hiding-place; concealment. 2 disguise
fidia: fine; ransom; compensation; damages: ~ ya kuchelewa demurrage; offset; recompense; compensate; make amends; recoup; redress. () fidika; () fidiana; () fidisha; () fidiwa
fidla: fiddle; violin. (Kng)
fidua: uncover; reveal; expose. 2 undo (sth woven; matted; sewn etc.). () fidulia; () fiduliwa; () fiduka; () fiduana; () fidusha. fifi cheap; poor in quality; valueless. 2 fading; trifling
fifia: lose strength; droop; ebb; fizzle; deteriorate (in health). 2 dwindle; decline; fade; disappear.() fifilia; () fifika; () fifisha
figau: kitchen (in dhows)
fiili: act; deed; way of acting
fikia: put up; lodge: Wageni wame~ Hoteli ya Sheraton the guests have put up at the Sheraton Hotel. 2 arrive at; find; hit. 3 range. () fikika; () fikisha; () fikiwa
fimbi: crowned hornbill
fimbo: stick; mace: ~ rasmiceremonial mace. 2 walking stick
finga: protect by charms (against thieves; burglars etc.) () fingia; () fingika; () fingana; () fingisha; () fingwa
fingo: charm (to prevent thieves; burglars etc.)
finya: pinch; nip; press with fingers or nails. 2 make narrow. 3 scowl. () finyia; () finyika; () finyana; () finyisha/finyiza; () finywa; (ngozi) be wrinkled. 2 get thin. 3 be stunted. 4 wither away. () finyalia; ()finyaka; () finyasha
finyo: pinch. finyu shallow; parochial: Juma anamtazamo ~ Juma is shallow minded. 2 narrow; constricted
fiodi: fiord. (Kng)
fisha: kill; cause death; dispatch; extinguish. 2 discourage. Kauli ya ~discouraging statement. 3 quench. () fishia; () fishika; () fishana; () fishiza; () fishwa
flora: flora. (Kng)
fokea: rant at sb; scold. () fokelea; () fokeka; () fokeana; () fokesha; () fokewa. foko1 plenty
folio: folio. (Kng)
fonti: font. (Kng)
fotoa: photograph. () fotolea; () fotolewa; () fotoka; () fotoana; () fotosha. (Kng)
fremu: frame. (Kng)
friji: fridge; refridgerator. (Kng)
friza: freezer. (Kng)
fuadi: heart
fuasa: imitate. 2 follow. () fuasia; () fuasika; () fuasana; () fuasisha; () fuaswa
fuata: follow; come after; pursue. 2 imitate; be with sb; be attached to. 3 observe; comply; conform; abide: ~ sheria abide by the law. (nh) ~ nyayo follow someone's footsteps. () fuatia; () fuatika; () fuatana; () fuatisha; () fuatwa
fuawe: anvil
fueli: fuel. (Kng)
fufua: resurrect. 2 revive; recall; regenerate; revamp: ~ deni revive a debt. ()fufulia; () fufuliwa; () fufuka; () fufuana; () fufusha
fukaa: wear out; wither. 2 tingle with excitement. () fukalia; () fukaka; ()fukaza
fukia: bury; inhume. 2 fill up a hole. () fukilia; () fukika; () fukisha; () fukiwa
fukua: dig up; exhume; disinter. ()fukulia; () fukuliwa; () fukuka; ()fukuana; () fukusha
fukuo: act of exhuming or digging out. 2 dug up hole
fumba: shut; close: ~ macho close the eyes; ~ mdomo close the mouth. 2 complicate; elude. (ms) keep mum; speak in riddles: ~ na kufumbua in the twinkling of the eye. ()fumbia; () fumbika; () fumbana; ()fumbisha; () fumbwa; sleeping bag made of a mat. 2 burial mat. 3 basket for collecting cloves. fumukan.a; lump: ~ la unga lump of flour. 2 handful: Chota ~ moja la mchelescoop one handful of rice; foot prints of an animal
fumbi: small valley which stops rain water. 2 water furrow; leader during initiation rites
fumbo: parable: Ongea kwa ma~ speak in parables. 2 puzzle. 3 (hesabu) problem: Hili ni ~ this is a puzzle. 4 riddle; conundrum; mystery. 5 proposition; leadership rank
fumua: unstitch; unravel; disentangle. 2 undo. 3 remove: ~ moto remove firewood from the fire. 4 beat: ~ ngumi box sb. () fumulia; () fumuliwa; () fumuka; () fumuana; () fumusha
fumvu: bird resembling a pigeon
funda: pestle; pound: ~ makopa pound dry cassava. () fundia; () fundika; () fundana; () fundisha; () fundwa; instruct especially during initiation rites; inculcate; indoctrinate. ()fundia; () fundika; () fundana; () fundisha; () fundwa; mouthful; draught: Piga ~ la maji take a mouthful of water
fundi: craftsman: ~ mchundoartisan; ~ seremala carpenter; ~ mwashi mason; ~ wa reli plate layer; ~ makanika mechanic; ~ bomba plumber
fundo: knot; joint. 2 cluster: ~ la maua cluster of flowers; bouquet. 3 money saving knot. 4 (mwili) joint: ~ la mguu ankle. 5 hatred; anger: ~ la moyo ill feeling
funga: fasten; tie; bind (up): ~ kwa mbao board; ~ kwa mnyororo chain; enchain; ~ kidonda dress a wound. 2 imprison; intern. 3 immure; lock; close: ~ tunduni encage; envelop; hitch; fold. (nh) () ~ choo be constipated; (2) ~ safari start a journey; (3) ~ virago pack and go; (4) Ji~ kibwebwework hard; (5) ~ hesabu close accounts; (6) ~ mdomo keep quiet; (7) ~ kizazi undergo permanent contraception; (8) ~ uchumba get engaged; be betrothed; (9) ~ ndoa marry. () fungia; () fungika; () fungana; () fungisha; () fungwa; decide; make a decision: ~ beimake a deal. () fungia; () fungika; () fungana; () fungisha; () fungwa; fast; abstain from eating: Leo nime~ I'm fasting today. () fungia; ()fungika; () fungisha; win a game; score a goal. ()fungia; () fungika; () fungana; ()fungisha; () fungwa; (dini) fasting: Nimo katika ~I'm fasting
fungo: fasting period. 2 style of tying. 3 security; bond; civet cat; teething stimulant made from roots of nut grass (cyperus rotundus)
fungu: heap; pile; chump; mass. 2 share; portion; slice: ~ la fedha a share of money. 3 paragraph; section; sentence. 4 (biashara) stock; share. 5 (sheria) article; paragraph; plant whose stems and leaves are used as vegetable (celasia orgentea)
funua: uncover; discover. 2 reveal; bare; disclose; divulge; expose. 3 spread out: ~ mbawa spread out wings. 4 disentangle. ()funulia; () funuliwa; () funuka; ()funuana; () funusha
funza: educate; teach esp good manners. () funzia; () funzika; ()funzana; () funzisha; () funzwa; jigger; sand fleas. 2 larva; maggot; grub
funzo: lesson; teaching
fursa: opportunity; occasion: Kupata ~ to have an opportunity. furufu joyful; cheerful
fusho: fumigant; incense. 2 gun powder
fusia: fill up a hole; fill in a foundation. () fusilia; () fusika; () fusiana; () fusisha; () fusiwa
fuska: adulterer; fornicator
futia: grab; catch. () futilia; () futika; () futiana; () futisha; () futiwa
futua: take out; unsheath. 2 fyatu.a open up/untie a parcel. 3 pluck hair or feathers. 4 reveal; uncover; expose. 5 cause to swell; blow up. () futulia; () futuliwa; () futuka; () futuana; () futusha
fuuza: keep on; continue; go directly. () fuuzia; () fuuzika; () fuuzisha
fyata: tuck between the legs. 2 shut up; keep quiet. 3 hit (with a stick). (nh) ~ mkiashut up; withdraw out of fear. () fyatia; ()fyatika; () fyatana; () fyatisha; () fyatwa; catapult; slingshot
fyeka: mow; cut grass or bush. 2 destroy. () fyekea; () fyekeka; () fyekana; () fyekesha; () fyekwa
fyeko: cleared ground. 2 stroke of grass cutting
fyoma: read. () fyomea; ()fyomeana; () fyomeka; () fyomesha; () fyomwa
fyosa: insult; joke; kid. () fyosea; () fyoseka; () fyosana; () fyosesha; () fyoswa
fyoto: expression of contempt; or prohibiting to do sth
fyoza: insult; joke; kid. () fyozea; () fyozeka; () fyozana; () fyozesha; () fyozwa
fyuka: (mtego) spring; go off suddenly. () fyukia; () fyukika; () fyukisha
fyuzi: fuse. 2 (ms) madness:Amekatika ~ he is mad. (Kng) G G; g
gaidi: bandit; terrorist; rebel; renegade; dissident; robber; guide. (Kng)
gaiga: geiger. (Kng)
galme: mizzen sail. 2 mizzen-mast
gamba: scale; hard cover; carapace; cortex; bark: ~la gangaiz.a samaki scale of a fish
gamti: unbleached calico. 2 brown rice
ganda: skin; bark; hull; husk; shuck; (yai) shell; (tunda) peel; rind; (risasi) cartridge; curdle; coagulate: Maziwa ya ~ curdled milk. 2 congeal; freeze: Maji yame~water has frozen. 3 glue. () gandia; ()gandika; () gandisha; pursue. () gandia; ()gandika; () gandana; () gandisha; () gandwa
gandi: sheet
gando: nipper leg of a crab/prawn. 2 crab's claw
ganga: cure; heal (illness). 2 mend; repair. () gangia; () gangika; () gangana; () gangisha; () gangwa
gange: limestone; work; job
gango: repair. 2 treatment. 3 filler. 4 joint; joining. 5 vice
ganja: type of two masted vessel; rolled up marijuana
ganjo: place
ganza: (sie) hesitate; falter; wobble. ()ganzia; () ganzika; () ganzisha; () ganzwa
ganzi: numbness. 2 apoplexy. 3 anaesthesia
gashi: (sio rasmi) girl
gatua: ~ madaraka decentralize. ()gatulia; () gatuliwa; () gatuka; ()gatusha
gauni: dress; gown. (Kng)
gawia: distribute to; dole out; allocate; assign; divide among. () gawika; ()gawiana; () gawisha; () gawiwa
gawio: talent; dividend
gendi: nipper
genge: escarpment; cliff; precipice; chasm; food kiosk. 2 vendor stall. 3 small market; clique; crowd; gang; pack. geni foreign: Kiingereza ni lugha ya ~ English is a foreign language; 2 strange; new:Habari hii ni n~ kwangu this is news to me.Tabia hii ni n~ kwetu this is a strange behaviour to us. 3 queer
geuka: change; be transformed. 2 turn; turn arround. () geukia; () geukika
geuko: change; transformation
geuza: change; modify; modulate. 2 alter; cast; transform. 3 turn upside down; bring round; direct to/towards. () geuzia; ()geuzika; () geuzana; () geuzwa. geuzi changing; changeable; fickle; transforming
ghafi: gross weight; valueless; trifling; raw; unprocessed:Mali ~ raw material(s)
ghala: storeroom; storehouse; warehouse: ~ ya nyasi kavu hayloft. 2 cotyledon. 3 arsenal: ~ ya silaha armoury. 4 gerner
ghali: expensive: Chakula ni ~ siku hizifood is expensive nowadays
ghama: be unique; be exceptional. ()ghamia; () ghamika; () ghamisha; () ghamwa
ghamu: grief; deep sorrow; sadness; melancholy; distress: Tia ~ cause grief; Fanya/ingiwa na ~ get grief
ghani: sing; recite. () ghania; () ghaniana; () ghaniwa; () ghanika; () ghanisha; melody; tune
ghasi: fluster; trouble; bother; disturb. () ghasia; () ghasiana; () ghasiwa; ()ghasika
ghawa: money
ghaya: apex; top of sth: Nimefurahi ~ I am beyond exaltation
ghazi: war. 2 steam; air. ghazi; fighter; hero; combatant
ghera: determination
ghibu: disappear; vanish
ghila: income
ghuba: gulf; bay; inlet: ~ ya AjemiPersian Gulf
ghuma: debacle
ghuri: cheat; deceive; beguile. ()ghuria; () ghuriana; () ghuriwa; ()ghurika; () ghurisha
gilda: guilder. (Kng)
gimba: body; mass
gimbi: model; shape
gingi: peg or stake. ging'amu* gingham. (Kng)
gitaa: guitar. (Kng)
glopu: bulb; globe. (Kng)
glovu: glove. (Kng)
goboa: (mahindi) pluck. 2 (karafuu; pamba) pick off the stalks. 3 extract sth e.g. a nail; rip.() gobolea; () goboka; ()gobesha; () gobowa
gobwe: knock-knees
gofia: sail boat pulley
gofua: weaken; cause to be skinny:Maradhi yamem~ illness has made her skinny. () gofulia; () gofuka; () gofuana; () gofusha; () gofuwa
gogoo: yoke. 2 wooden fetter. 3 act of loving one's divorcee
gomba: quarrel (with); argue (with). ()gombea; () gombeka; () gombana; ()gombeza; () gombwa
gombo: sheet; leaf of a book; (Mwambao wa Afrika ya Mashariki) offering ceremony
gonda: rock-lizard
gondi: crab/lobster's claw
gonea: be stuck; be static; stay. ()gonelea; () goneka; () gonesha
gonga: beat; strike. 2 (mlango) knock. 3 (gari) hit; crash. () gongea; () gongeka; () gongana; () gongesha; () gongwa
gongo: club; thick heavy stick. got.a; local spirits
gonya: calm/appease spirits. ()gonyea; () gonyeka; () gonyana; () gonyesha; () gonywa
gooka: retch; gobble. () gookea; () gookoka; () gookesha; () gookwa; fallen spoilt coconut
gotea: doze; be drowsy. () gotelea; () goteka; () goteza
gotoa: summarize. 2 conclude. 3 inform; teach; inculcate: ~ mkutano saa 11conclude the meeting at 5 p.m. () gotolea; () gotolewa; () gotoka; () gotosha
gramu: gram/gramme. (Kng)
greda: grader. (Kng)
gredi: grade: ~ ya kwanza first grade; Mwalimu wa ~ A grade A teacher. (Kng)
gridi: grid: ~ya taifa national grid. (Kng)
grife: slate stone
grisi: grease. (Kng)
guano: guano
gubua: reveal a secret; uncover. ()gubulia; () gubuka; () gubuana; () gubusha; () gubuwa
gulio: open market; mart
gumba: thumb: Kidole ~ the thumb; famine. gumba3 sterile; barren; infertile: Mtu ~infertile/sterile person
gumbu: wild cucumber calabash. 2 musical instrument made out of a calabash
gumea: person who burns incense during exorcism
gumia: growl; groan. () gumilia; (tdes) gumilisha; () gumika; () gumiana; () gumiwa. gumu rigid; hard; solid; compact. 2 complicated; difficult; abstruse; callous; inflexible; refractory; tough: Hesabu n~ difficult sum. 3 brave; courageous; unyielding. 4 miser
gumzo: chat; small gur.a talk
gunda: horn; bugle. 2 siren; voluntary work. 250 acre farm
gundi: gum; glue; paste. (Khi)
gunga: treat medically. 2 diet; refrain from sth for health reasons; keep a taboo. 3 overcome a temptation. () gungia; () gungika; () gungisha; () gungana; () gungwa; warn; caution. () gungia; () gungika; () gungisha; () gungana; () gungwa
gunge: expert; master; craftsman
gungu: kind of old East African coastal dance
gunia: sack. (Khi)
gunzi: grainless maize cob
gusia: touch on (sth); mention; adumbrate; allude: Mgombea ali~ tu mikakati ya kuinua uchumi the candidate only touched on the strategies to improve the economy. ()gusika; gwato () gusisha; () gusiana; () gusiwa
gutua: startle; frighten. 2 surprise. ()gutulia; () gutuka; () gutusha; () gutuana; () gutuwa
gwagu: tom cat; stray cat; wild cat. 2 degenerate/cruel person
gwara: copper/silver coin
gwase: wild pig; wild boar
gwata: trip sb up. () gwatia; () gwatika; () gwatisha; () gwatana; () gwatwa
gwato: crutch. 2 gway.a stilt. 3 harpoon (for spearing large fish). 4 twisting of an opponent's leg during wrestling
gwaya: quiver; tremble; shiver. ()gwayia; () gwayika; () gwayisha
gwaza: scrape grass. () gwazia; () gwazika; () gwazana; () gwazisha; () gwazwa; speak hesitantily. 2 prevent; hinder; hamper. () gwazia; () gwazika; () gwazisha; () gwazwa
gwiji: expert/ace/star of a certain specialization or art: ~ wa rege reggae star. H ha! oh!; utterance of surprise or dismay. haba1* scarce; rare; short of; few; insufficient; scant; spare. (mt) ~ na ~ hujaza kibaba little and little fills the measure
habta: anchor
hadaa: cheat; deceive; outwit; hoodwink; play a joke/trick (on sb). ()hadaia; () hadaiwa; () hadaika ()hadaana
hadhi: status; prestige; honour; respect; dignity: Shushia ~ disparage
hadia: present; gift
hafla: reception; party: ~ ya harusi a wedding reception
haiba: charm; attraction; charisma. 2 (tabia) amiable; personality; pleasant: Mwingi wa ~ full of amiable character. 3 beauty
haima: tent-like tarpaulin cover in a dhow. hainehaine airborne; shoulder high
haini: betray; deceive; traitor; betrayer; conspirator; renegade
halua: sweetmeat
hambe: stupid person; imbecile
hamdi: praise; commendation; applause. 2 qualifications
hamia: assault; attack. () hamika; () hamisha; () hamiana; () hamiwa; immigrate; move to. ()hamika; () hamisha; () hamiwa
hamio: settlement for migrants; new settlement
hamna: is nothing; is empty
hamsa: five: ~ wa ishirini twenty five
hando: copper vessel; like a clay water pot; used chiefly by Indians for carrying and storing water. (Khi); pancake dipped into boiled sugar; short flaring skirt usually won by Mijikenda women. hangahanga1 shoulder-high
hanja: brown; loiter; wander () hanjia; () hanjika; () hanjisha
hansa: two thick ropes of the main yard
haram: pyramid. 2 exalted area around Madina and other graves of famous people. harambee! heave  ho! yo- heave  ho!
hario: hurray! harioe! hip hip hurray!
hasho: (chombo) plug
hasua: testicles
hatia: fault; guilt; culpability: Eliezer hana ~ Eliezer is not guilty
hatua: step; pace in walking: ~ mbili mbele two paces forward. 2 progress; advancement. 3 opportunity; time: Nitakuja nikipata ~ I will come if I get the opportunity. 4 action: Chukua ~ take action. (nh) () Piga ~advance; go ahead; Vuta ~ increase the speed; speed up
hauli: memorial
hawaa: last; passionate desire; infatuation
hedhi: menses; menstruation:kukatika ~ menopause
hekta: hectare. (Kng)
hemea: be extremely busy; tire due to heavy workload. 2 fail to do sth. 3 go far away in search of food when hunger strikes. ()hemelea; () hemeana; () hemeleka; () hemesha; () hemewa. hemer.a pia; look for food. ()hemerea; () hemereka; () hemerana; () hemeresha; () hemerwa
hemka: be ecstatic; be inspired. ()hemkia; () hemkika; () hemkisha
henza: halyard
heria: anchor; cast anchor. ()herilia; () herikia; () herisha.(Kre)
hewaa: pia ewaa! Yes; exactly. hewala! alright
hiana: mean. 2 unjust deed; unfair treatment; perfidy
hiari: choose; prefer. () hiaria; () hiarika; () hiarisha; choice; free will; volition; option; prerogative: ~ yako suit yourself; ~ yangujust as I want; Kazi ya ~ voluntary work; Jambo la ~ an act of grace
hijra: Hegira/Hejira
hindi: cob; corn cob
hisia: feelings; emotion; passion:~ za udhalili inferiority complex; ~ za majikwezosuperiority complex
hiuta: play and win a class game. ()hiutia; () hiutiwa; () hiutika; ()hiutisha. hivi like this; (in) this way: simama ~ stand in this way. 2 about: Waliondoka saa 7 ~ they left about .00 p.m. 3 just: Walikula sasa ~ they ate just recently. by the way. hivi hivi /so- so. hivyo (in) that way: Nenda ~ go that way; ~ ndivyo ilivyo that's how it is; Usifanye hivyo ~ don't do it that way; Kwa ~ so; in that way; Si ~not that way; that is not so. 2 those: ~ vitabuthose books. such: Usiwe mpumbavu ~ don't be such a fool
hodhi: monopolize; pile up; accumulate; hoard. 2 () hodhia; () hodhiana; ()hodhiwa; () hodhika; () hodhisha; estate; wasteland and under the ownership of sb. 2 bath tub; footbath. 3 water tank; resrvoir
hombo: secret
homoa: enjoy food esp. soft and tasty. 2 cook sth such as potatoes till they become very soft. () homolea; () homoka; ()homoana; () homosha. hombo1 plentifully; in abundance: Leo kuna samaki ~ today there is fish in abundance
honga: bribe; get at sb. 2 seduce with gifts. 3 pay one's way; pay toll; tribute. ()hongea; () hongesha; () hongeka; ()hongana; () hongwa. hongea! acknowledge! Thank you (congratulation) ~! congratulations!; acknowledge
hongo: bribe. 2 sth given to hongwe seduce a woman. 3 passage toll paid to local chiefs
honza: arrow made of a millet straw and a wooden head
hulka: character; innate peculiarity
hunde: hideous; unhandsome
hundi: cheque. (Khi)
huree: yippee!
huria: freedom. free; independent; open. huria2 ad libitum; freely
ibada: worship; religious service. 2 habit; common practice; rite: Kulewa kumekuwa ~ kwake his drinking has become a habit
ibana: commit adultery
ibara: clause; article; paragraph
ibuka: emerge; spring up; bob up; resurface. () ibukia; () ibukika; ()ibukisha
idadi: quantity; number: ~ ya watupopulation/number of people
idara: department: ~ ya KiswahiliKiswahili Department
idhaa: radio programme; broadcasting; unit: ~ ya Taifa ya radio Tanzania National Programme of Radio Tanzania; ~ ya Kiswahili ya BBC BBC Kiswahili service
idili: effort; undertaking; attempt; struggle
ifaki: reconvert; reinstate
igiza: imitate; impersonate: Mchezo wa ~ drama; play. () igizia; () igizika; () igizana; () igizisha; () igizwa
igizo: act; skit: Sanaa ya ma~drama; play
ijapo: although. ijapokuwa although; even though
ijara: recompense: Swala ya ~ a recompense prayer. 2 wages. 3 wharfage; custom tax
ijaza: permission to do something which is valued especially in religion. 2 acknowledgement. Ijumaa
ikabu: punishment; disciplinary action
ikama: establishment; manpower. 2 call to begin a mass prayer
ikiwa: if; suppose
ikiza: arrange; lay across; set beams in position for roofing: ~ nyumba boriti lay the beam across. () ikizia; () ikizika; ()ikizisha; () ikizwa
ikulu: state house
ilahi: God
ilani: warning; caution; notice. 2 manifesto
iliya: visit: Wageni wameni~ nyumbani kwangu I have visitors in my house. () iliyia; () iliyika; () iliyana; () iliyisha
imamu: Imam
imani: faith; belief; morale; persuasion; conviction; dogma: ~ potofu:misguided belief; ~ kwamba kuna Mungu mmoja tu monotheism
imara: /firm; solid; robust; stable; rigid; tenacious; unshakeable; determinate; strong; substantial; unfaltering: Simama ~ be firm
inadi: provocation; teasing
inama: bend; stoop; bow; lean; sag; tilt; tip. 2 follow command. () inamia; ()inamika; () inamisha
inchi: inch. (Kng)
ingia: enter; get in; go into sth; incur; pierce. 2 matriculate; join a group/association/party: ~ chamani join a party. () ingilia; () ingilika; () ingiana; ()ingiza; () ingiwa
inika: bring down; bend: ~ mzigo unload; bend down: ~ kichwa bend the head. () inikia; ()inikika; (); inikiza; () inikana; ()inikwa
iniza: suspend; hang. ()ning'inizia; () ning'inizika; ()ning'inizana; () ning'inizwa
insha: essay; composition. inshallah* God willing; if God wills
inuka: get up; stand. () inukia; ()inukika; () inukisha
irabu: vowel
ishia: finish up; end at; resort to. ()ishilia
isimu: linguistics: ~ jamii social linguistics; ~ matumizi applied linguistics; emphatic negation: Nimefika mkutanoni hapana ~ ya mtu I arrived at a meeting but there wasn't a single person
itika: reply; answer; respond. ()itikia; () itikika; () itikisha
itiko: answer. 2 response
itilo: big rope used in vessels tied from both sides of vessel yard to the poles
izara: shame; disgrace: Patikana na ~get/be ashamed
jaala: grace of God; talent; endowments
jaaza: fate; destiny
jaivu: jive: African-American dance style. (Kng)
jalia: grant; empower; enable. 2 be gracious (to) esp. of God's favour: Tutaonana Mungu akitu~ we'll meet; God willing. ()jalilia; () jalika; () jaliana; () jalisha; () jaliwa; taz. Jalali
jamaa: relative. 2 colleague. 3 somebody; bloke; guy
jamba: fart; break wind. () jambia; () jambiana; jamvi () jambiwa; () jambika; () jambisha
jambo: (mambo) matter; business; circumstances; fait accompli: Mambo ya serikaliGovernment business; ~ la lazima sine qua non; ~ dogo/hafifu trifle; ~ la hatari venture. 2 difficult; trouble: Miji imejaa mambo towns/cities are full of troubles
jamia: assembly; crowd; mass of people
jamii: have sexual intercourse; copulate; sleep with. () jamiia; ()jamiiana; () jamiiwa; () jamiika; () jamiisha; community; society; body; the mass; the public. 2 brand; breed; groups; (biolojia) phylum. ~a jamii social; socio:Elimu ~ sociology; ~ kamili ya kufikirikautopia
jamvi: big floor mat made of straw. 2 concrete floor jana of a building. 3 fine given in local courts. nh () ~ la wageni prostitute who entertains guests and visitors; (2)Kunja ~ wind up business/activity; (3) Lipa ~pay costs of running a case
janaa: shame; disgrace; dishonour
jando: circumcision rites. 2 group of young men attending circumcision rites
janga: calamity
janja: canny; knowing; crafty; long-headed; oily; sly
janna: disembodied spirit
jasho: sweat; lather. 2 effort; hard labour: Hilo ni ~ lako that is your own effort/earning
jazba: emotion. jazi
jazna: present; reward; gift. 2 present given by a bridegroom to his virgin bride
jembe: hoe
jenga: build; construct; make. 2 develop: ~ taifa build/develop a nation; ~ hojamake one's point. 3 groom sb; elevate sb. ()jengea; jiamin.i () jengeka; () jengana; () jengesha; () jengwa
jengo: building; construction: ~ la ukumbusho monument; ~ la duara rotunda
jeshi: army; force; troop; paratroops: ~ la ulinzi defence force/army; ~ la Polisi police force. 2 great company; assemblage:~ la wokovu salvation army
jeuri: rudeness. rude; insolent; strong-minded; saucy
jicho: eye; optic: ~ la husudaleer. 2 ornament on prow of a vessel. 3 flower bud: (nh) () sina ~ la kumtazamia I feel ashamed to look at him/her; (2) Yu macho he/she is awake; (3) Finya ~ wink; (4) Kaa macho stay awake; take care; (5) Yangu macho I will not comment
jifya: hearth stone; firebrick
jimbi: cock; rooster; taro plant/tuber. 2 bracken
jimbo: province; tract. 2 constituency. 3 (la askofu) diocese; medicinal bath given to babies to keep them healthy
jimbu: rainwater trench
jinai: crime: Kesi ya ~ criminal case
jinsi: type; sort; manner; process. 2 sex. such as
jiona: be conceited; boast. () jionea; () jionesha
jioni: evening
jipya: New Testament. Agano la
jitia: affect: ~ hamnazo affect ignorance; intermeddle; interpose
jitoa: concede; retire; withdraw; yield. () jitolea; () jitoza
jivii: gentian-violet
jizia: tax paid by non Muslims in a muslim country
jogoo: ma cock; rooster; capon. 2 hero (ms) ~ la kwanza around 2 a.m; ~ la pili jubur.u around 4 a.m
jongo: rheumatism
joshi: windward movement of a vessel. joshi2 fast: Enda ~ go fast
josho: dipping trough
jouli: (umeme) joule. (Kng)
jugwe: tug of war
juisi: juice: ~ ya ndimu lime juice. (Kng)
julai: July. (Kng)
julfa: chignon
jumba: large house; mansion; palace; ~ la makumbusho museum; ~ la maonyesho/michezo theatre; ~ la RaisPresidential Palace; State House
jumbe: headman
jumbo: shape (of a person)
jumla: total; sum; summation; lump. 2 wholesale
junaa: shame; scandal
junju: hair tuft
jutia: rue; regret: Nina~ siku ya ... I ruoe the day when
juvya: inform; acquaint
juzuu: chapter of Quran. 2 volume; tome. K ka! gosh! gracious!
kaaba: Kaabah
kacha: be adamant. 2 abscond; evade: Mtoto ame ~ kwenda shule the child absconded from school. 3 condense; coagulates; thicken: Samli hii ikipikiwa chakula hu~ when this fat is used in cooking food it coagulates. 3 be numb: Mkono wangu ume~ my arm is numb. () kachia; ()kachika; () kachana; () kachisha; () kachwa. kacha!2 word expressing the sound of sth light falling down
kachu: cachou
kadha: particular/certain number; additional prayer made in a fast day after basic prayers; routine timetable
kadhi: Islamic judge; kafara cadi; emir
kafua: thrash grain; beat off husks. ()kafulia; () kafuliwa; () kafulika; ()kafulisha
kagua: inspect; survey; examine: ~ shuleinspect a school; ~ jengo survey a building; ~ mahesabu audit accounts. () kagulia; (tdek)kagulika; () kaguliwa; ()
kaida: custom; regulative principle; norm
kaidi: be obstinate; contradict; disobey; be head-strong. () kaidia; ()kaidiana; () kaidiwa; () kaidika; () kaidisha; obstinate; disobedient; rebellious; refractory
kaifa: news; information; report: Nipe ~ ya safari yako give me a report of your journey. kaifa2 let alone; not to mention
kaimu: Acting: ~ Mkurugenzi acting Director; exorcist
kaini: (dini) cain. (Kng) kaini brutal; cruel. 2 arrogant; haughty; contentious
kakao: cocoa. (Kng)
kalia: sit on. 2 delay purposely: Ame ~ faili langu he purposely delayed my file.()kalilia; () kalika; () kaliana; ()kalisha; () kaliwa
kamba: rope; cord; string. 2 (viatu) lace; line. (ms) kata ~ die; escape; shrimp; prawn. 2 crayfish. kamukunji
kambi: camp. (ms) piga ~ set up/pitch a camp; vunja ~ strike camp. (Kng); (bio) cambium. (Kng) kambirani ! who cares! So what!
kambo: mama/baba wa ~ step mother/father
kamia: be anxious to do sth. 2 be insistent in demanding sth.3 menace. ()kamilia; () kamika; () kamiana; ()kamisha () kamiwa. kamili complete; exact; perfect; absolute. kamilifu perfect; exact
kamsa: alarm; siren
kamua: squeeze out; press out; wring out. 2 make sb bankrupt; squeeze sb sth. ()kamulia; (tdek) kamulika; (tdes) kamulisha; () kamuliwa; () kamuana
kamwe: never; not at all
kanda: knead: ~ unga knead flour. 2 massage: ~ mguu massage the leg. () kandia; () kandika; () kandana; () kandisha; () kandwa; bag woven from straws/palm leaves for storing food and other items. (Kaj); fee paid to a medicine-man; cheat. 2 wilful/ perverse person. 3 impotent man; zone; hand oars used when swimming; tape (for a radio/ video cassette)
kande: dish of mixed maize and beans
kanga: guineafowl; lady's print cotton wrap
kania: medicinal herb whose roots are used to treat cramps
kanja: plaited coconut palm leaf. 2 mat made of strips of palm leaves
kanju: starch. 2 porridge; cashew apple. (Khi)
kansa: cancer. (Kng)
kanta: black colouring for hair
kanya: forbid; rebuke. () kanyia; () kanyika; () kanyana; () kanyisha; () kanywa
kanza: warm; heat up: ~ mikono warm the hands. () kanzia; () kanzika; ()kanzana; () kanzisha; () kanzwa
kanzi: (hidden) treasure. 2 data bank; pilaf
kanzu: cassock; long sleeved plain calico robe. 2 gown: ~ ya mfuto plain robe; ~ ya ziki robe/gown with white cotton stitching at the neck; ~ ya kazi embroidered robe
karaa: long text of Koran consisting of numerous verses
karai: large metal basin
karia: village
karii: Koran reader (esp of tajuwidi). 2 book reviewer; critic
karne: century
karua: Indian sailor. 2 Indian caste of potters
karwe: devil- fish
kasha: box; chest; case: ~ la fedha money box. 2 silver box. (Kre)
kasia: oar; paddle
kasma: vote; financial allocation
kasra: vowel /i/ in Arabic script
kasri: palace. 2 mansion; chateau
kataa: refuse; decline; disagree; disavow; reject. 2 deny; renounce: ~ katakatarefuse completely. () katalia; ()kataliana; () kataliwa; () katalika; () kataana; () kataza. katakat. a hack. () katiakatia; ()katikakatika; () katishakatisha; ()katwakatwa
katua: cultivate. () katulia; (tdek)katulika; () katualiana; () katuliwa; () katuka
kauka: dry. 2 wither. 3 harden. () kaukia; () kaukiana; ()kaukiwa; () kausha; () kaukwa
kauli: statement; promise. 2 comment; feeling
kaumu: crowd; multitude; followers
kauri: cowrie shell. 2 earthenware. (Khi)
kauta: dust; grit
kauzu: dry sardines. 2 shameless person. kavu dry; parched. 2 barren
kawia: be late; delay; lag; linger. ()kawilia; () kawiza
kazia: emphasize. () kazisha; ()kaziwa. keba! hurrah!
kefya: wink 2 despise. 3 disturb.()kefyea; ()kefyeka; ()kefyana; ()kefyesha; ()kefywa. kejekeje loose
kekee: pia; bracelet; auger
kelbu: dog
kemba: peel. () kembea; keme.a () kembeka; () kembesha; ()kembwa
kemea: scold; rebuke; carp (at); objurgate. () kemeka; () kemeana; ()kemeza; () kemewa
kemia: chemistry. (Kng) kemkemu plenty
kenda: nine
kende: scrotum; testicle
kenga: deceive; cheat. () kengea; () kengeka; () kengana; ()kengesha; () kengwa
kenge: (--) monitor lizard
kengo: deceit; trick
kenua: grin; show teeth. () kenulia; () kenuliana; () kenuliwa; ()kenuka; () kenuana; () kenusha; ()kenuliwa. kenyekenye absolutely; entirely
keria: carrier. (Kng)
kesha: vigil; keep vigil. () keshea; ()kesheka; () keshana
keshi: cash. (Kng) keshia*cashier. (Kng)
kesho: tomorrow; future. 2 doomsday; Last Judgement; Judgement day
kiaga: promise; agreement
kiali: flame
kiama: doomsday; Last judgement; Judgement day
kiamo: vi colostrum
kiamu: Kiswahili dialect spoken on Lamu Island; (-/vi-)rising during Maulid prayer
kiana: clay pot lid
kiapo: vi oath; fealty: Fanya/apa/ kula ~ take an oath; lisha/apisha ~ administer an oath; kibanzi kula ~ submit to an ordeal. 2. charm used as a protection against theft
kiasi: moderate amount; modicum; part/of: kula ~ eat. 2 moderation. 3 approximate amount: ~ cha shilingi elfu kumiabout ten thousand shillings. 4 price: shati hili ~ gani? what is the price of this shirt?; enough; average : amevuna chakula ~ he has an average harvest. 2 short while: Tembea ~ walk for a short while; bullet
kiatu: shoe : ~ cha ngozi leather shoe
kiazi: potato; (si rasmi) murphy: ~ kikuu yams; ~ kitamu sweet potato
kibao: slate. 2 small board (about 15 cm in length) used for sitting. 3 card for winding thread or wool on. 4 coconut grater. 5 quadrilateral board used for making concrete bricks. 6 blow; slap. 7 old hat/cap; hit song
kibia: earthware bowl (for serving food). 2 earthenware cooking pot
kibla: the direction of Mecca to which Muslims turn in prayer. 2 imam's alcove in the mosque. 3 north. 4 the Qaaba at Mecca
kibua: anything light in weight; tuna-like fish. kibubusa incognito; secretly
kicha: bunch/bundle of palm leaf strips; vegetables etc. 2 bunch of keys
kicho: fear; awe; reverence
kidau: ink pot; big scaled round floating fish
kidhi: satisfy. 2 fullfill: ~ haja satisfy needs; ~ swala observe prayers. () kidhia; () kidhiana; () kidhiwa; () kidhika; () kidhisha. kidigi very small (amount); little
kidoa: fleck. kidogo few; small: Kitu ~ a small thing. a little; a
kifaa: implement; instrument; device; tool; gadget
kifua: chest; bosom; breast. 2 chest disease: ~ kikuu tuberculosis. 3 strong heart; brave: Ana ~ he is brave
kifuo: stake fixed in the ground with pointed end for ripping off the husk of coconut
kifuu: empty coconut shell; cuttle-fish bone
kigae: small potsherd; small broken piece of earthenware. 2 roof tile
kigoe: forked stick for plucking fruits or pulling down branches; fruit hook. 2 golf club
kigwe: braided necklace
kiila: denial; negation
kiima: subject (of a sentence)
kiini: nucleus. 2 (tunda) kermel; stone. 3 (yai) yolk. 4 (mti) heart; hard core. 5 foetus. 6 essence; (si rasmi) nitty-gritty; gist: ~ cha tatizo hili the esence of this problem
kijaa: grain grinder. kijakazi
kikae: Swahili dialect spoken in Makunduchi (Zanzibar south). 2 old Swahili: ~ cha Shungwaya Old Swahili of Shungwaya
kikao: sitting place. 2 meeting; sitting; session
kikoa: co-operation; partnership. 2 meal eaten in common (in which each member provides food by turns). 3 field
kikoi: loin cloth
kikuu: university. chup! shut up; be silent
kikwi: & one thousand. 2 many; plenty: Kumekuja watu ~ many people came. kila each; every. all: ~ siku everyday; daily; ~ mtu everyone
kileo: intoxicant; liquor; alcohol
kilio: wailing. 2 cry; shout. 3 mourning. 4 problem. ~ cha maji water problem
kiloo: hard core; stubborn person; uncompromising person
kilua: small aromatic white flower. 2 women traditional dance
kimau: short sleeved collarless tunic
kimba: dead body; corpse; dung; faeces
kimea: malt grain sprout
kimia: casting net; goal net; netting. 2 lace work. kimiani in the goal net: Moshi aliingiza mpira ~ baada ya kuwapiga chenga walinzi Moshi kicked the ball into the goal net after dodging the defenders
kimio: epiglottis. 2 uvula
kimwa: satiate; surfeit
kimya: silence; quietness: ~ ni dalili ya kukubali silence implies consent. kimya2 silent; mute; quiet: Mtoto m~ quiet child; ~ ~ silently; quietly; kaa ~! be quiet! kina1 group of similar people ~ mama women folk; ~ yahe common people
kinaa: surfeit; satiety; satisfaction. kinaganaga thoroughly; in depth; clearly:Eleza ~ explain clearly
kinai: be surfeited; be satiated; be satisfied. () kinaia; () kinaiana; ()kinaiwa; () kinaika; ()kinaisha. kinaifu easily satiated/surfeited
kinda: chick . 2 young shoot:Mnazi m~ coconut shoot. 3 youth. kindakindaki1 genuine; proper; original; pure. 2 aristocratic; of noble birth: Mimi mwana ~ nimeoa kisonoko I am an aristocratic married to an ill-bred person. kindakindaki2 shoulder-high; aloft: alibebwa ~ he was carried shoulder-high. kindanindani secretly; secretively
kindi: squirrel
kinga: guard; protect; defend; ward off. () kingia; () kingika; () kingana; () kingwa; protection; defence; prophylatic; obstruction: Ukosefu wa ~ mwilini (UKIMWI) acquired immune defficiency syndrome (AIDS)
kingo: threshold. 2 edge; end: ~ za dunia end of the earth; cataract. king'on'
kinoo: whetstone
kinza: obstruct; demur; impede. 2 oppose; counteract; contradict; object. ()kinzia; () kinzika; () kinzana; () kinzisha; ()kinzwa. kinzani obstinate; opinionated; ambivalent
kioja: oddity; freak
kiomo: tip; apex; peak: ~ cha nchicape; promontory; headland; ~ cha chomboextremity of prow
kiota: nest; roost
kipeo: gourd. kipeo2nm vi- power; exponent: Mbili ~ cha nne two to the power of four; ~ cha pilisquared; ~ cha tatu cubed; climax
kipia: apex; pinnacle. kipia; leaves used for colouring fishing line
kipwa: rock dry patch (left by receding tide); shallow waters
kipwe: shrike; catcall (for calling sb)
kipwi: convenience chamber. 2 gunwale
kiraa: style of reading Koran
kiruu: rage; fury
kisaa: piece of cloth; remainder; left overs
kisia: estimate; guess. () kisilia; ()kisika; () kisiana; () kisiwa
kisra: ancient title for Persian Kings
kiswa: robe (esp; religious)
kitia: transplant (a plant); plant out. ()kitilia; () kitika; () kitisha
kitua: thin leaved gray stemed cassava plant
kituo: stop: ~ cha basi. bus stop; intermission; stopover. 2 end of a journey. 3 station: ~ cha mabasi bus station; ~ cha treni/gari la moshi railway station; ~ cha PolisiPolice Station; ~ cha ndege (za jeshi la anga)air-base; full stop; silence; peace; calmness; quiteness. kitutu (ms) Piga/pigwa ~ be beaten by many people at once
kiuka: step over; get over without touching. 2 evade; infringe law/rules. (ms) ~ mpaka transgress; ~ sheria break the law. ()kiukia; () kiukika; () kiukana; ()kiukisha; () kiukwa
kiuno: waist; loin. 2 concrete foundation
kiwaa: blurred vision: ana ~ his vision is blurred; he is not able to see distinctly. 2 unclear situation; uncertainity
kiweo: thigh; ham; hip
kizio: half of anything round: ~ cha nazi half of a coconut; (hesabu) unit; base
kizuu: porridge of soft kizuu raw maize; evil spirit said to be employed by witches and wizards to enter houses in the form of a rat and kill people by devouring their livers
klabu: club: ~ ya mpirafootball club. 2 bar; pub. (Kng)
koboa: husk grain/corn. () kobolea; (tdek) koboleka; (tdes) kobolesha; ()kobolewa; () koboka; () kobosha
kobwe: pea bean; kind of snail. (nh)Piga ~ clap with hollowed hands; or with the hands on the biceps; umbilical hernia
kocha: coach: ~ wa mpirafootball coach. (Kng). koga
koche: dwarf palm fruit; lobster
kochi: couch; sofa. (Kng)
kocho: harpoon. 2 briefs; underpants. kochokokocho plenty
kodoa: stare; gaze; gawk: (nh) ~ machostare at; gaze on; eye sb/sth. () kodolea; (tdek) kodoleka; () kodoleana; ()kodolewa
kodwa: small stone; used as a marble in playing games
koeka: catch by hooked stick: (nh) ~ mwari make definate arrangements so that an initiate will be under your charge. () koekea; () koekeka; () koekesha; ()koekwa
kofia: hat; cap : ~ ya bulibuli white embroidered skull cap; ~ ya kitunga (a kind of) tarboosh; ~ ya kiaskofu mitre
kohli: kohl
kohoa: cough; (rasmi) expectorate; hawk. () koholea; () kohoka; ()kohoza
kojoa: urinate; pass/make water. ()kojolea; (tdek) kojoleka; () kojoleana; () kojolewa; () kojoza
kokoa: sweep up rubbish. 2 husk grain. () kokolea; () kokolewa; ()kokoka; () kokoza
kokwa: stone of a fruit; kernel of a fruit
kolea: be well seasoned/flavoured:Chai ime~ sukari the tea has enough sugar. 2 (rangi) sink in. () koleka; () koleza; ()kolewa
koleo: pincers; pliers; tongs; shovel
kolwa: profit from/by; be better off. () kolwea; () kolweka; () kolwesha; be tired of doing sth repeatedly. () kolwea; () kolweka; () kolwesha
komaa: mature; ripen.() komaza
komba: scrape out; wipe clean: ~ chungu clean out a pot. 2 impoverish sb. ()kombea; () kombeka; () kombana; ()kombesha; () kombwa; bushbaby
kombe: shallow shell. 2 collar-bone; clavicle. 3 large dish; pan or platter of earthenware: ~ la harusi bridegroom's special meal; koranic medicinal drink; shell-fish; oyster; creeping plant whose poisonous sap is applied to arrow tips; (michezo) cup: ~ la dunia world cup; conch: elimu ~ conchology
komea: belt; fasten: ~ mlango belt a door. () komelea; (tdek) komeleka; ()komeleana; (tdes) komelesha; () komelewa
komeo: bolt; bar; latch. komeo; creek; inlet
komoa: unbar. () komolea; ()komolewa; () komoka; () komoana; () komoza; deprive of rights; rend asunder. () komolea; () komolewa; ()komoka; () komoana; () komoza; make sb concious; exorcize. () komolea; () komolewa; ()komoka; () komoana; () komoza
komoo: exorcism
komwe: seeds of climbing plant used as counters
konda: loose weight; become thinner; get thin. () kondea; () kondeka; ()kondesha
konde: fist. (nh) piga moyo ~have courage; piga ~ la nyuma bribe; plantation; cultivated land. 2 call to a person working in a field before greating him
kondo: recovery period after child birth:~ ya nyuma after birth; placenta; war; good health. kongoo
konea: cornea. (Kng)
konga: grow old; age. () kongea; () kongeka; () kongesha; () kongwa; quench thirst: Nipe maji kidogo nikonge roho Give me a little water to quench my thirst. () kongea; () kongeka; ()kongesha; () kongwa; assemble things or people. ()kongea; () kongeka; () kongana; ()kongesha; () kongwa
kongo: forearm
konje: small fox like animal
konzi: fist. 2 fistful of sth; handful of sth; knuckle
koplo: corporal. (Kng)
kopoa: peel (esp skin of a snake). 2 give birth; produce: Sina tumbo la kum~ mtoto kama huyo I can't bear such a child. ()kopolea; () kopolewa; () kopoka; () kopoana; () koposha. koramu
kordi: (muz) chord
korti: court. (Kng)
kosea: make a mistake; err; miss; fail:Ame~ kujumlisha he failed to add correctly; Ame~ njia he took the wrong path. 2 do wrong to; offend: ~ adabu mtu offend sb. ()koselea; () koseka; () koseana; ()kosesha; () kosewa. kosefu incorect
kosha: wash. 2 cleanse; absolve: Ji~restore one's image. () koshea; ()kosheka; () koshana; () kosheza; ()koshwa
koshi: slipper
kosoa: criticize. () kosolea; (tdek) kosoleka; (tdes) kosolesha; () kosolewa; () kosoana
kotia: dhow with two masts
kotwe: wild duck
kreni: crane; winch. (Kng)
kreti: crate. (Kng)
kromu: chrome. (Kng)
krosi: (mpira) cross. (Kng)
ktsie: sink; submerge; immerse. 2 set:Jua hu~ saa kumi na mbili jioni the sun sets at six in the evening. () zamia; () zamika; () zamisha
kuchi: red rooster (renowned for fighting). kud.a1kt fold/pull up clothes to above the knees. () kudia; () kudika; () kudana; () kudisha; () kudwa
kudra: nemesis
kulau: hold steadfast; insist on sth. 2 refuse to budge
kulia: right hand side: Mkono wa ~ right hand side; Pita ~ turn right. kulihali* by all means; by hooks and crooks
kumba: braided coconut leaf for fencing/roofing; push; shove; jostle. 2 gather; collect and lump together. 3 waste property. 4 cheat sb. 5 bail out water. () kumbia; ()kumbika; () kumbisha; (); kind of tilapia
kumbi: outer fibrous husk of coconut; initiation camp for boys. 2 hut for initiated boys
kumbo: shove; thrust. 2 sth done or carried at a go
kumbu: small sardines
kumvi: husk; chuff; hull
kunda: kind of spinach; pigeon
kunde: cow pea
kundi: group; flock; pack; crowd; multitude
kunga: secret/confidential teaching as in initiation settings; inside information
kungu: nutmeg; red snapper
kunja: fold; bend: ~ nguo fold clothes.(nh) ~ uso be annoyed/angry; frown; 2 ~ jamvi kupa call an end to a meeting. () kunjia; () kunjika; () kunjana ()kunjisha; () kunjwa
kunjo: fold; crease
kupaa: ascension: ~ Bwana The Anscension
kupau: part of a mast where a flag is hanged
kupia: blink; wink. () kupilia; (tdek)kupilika; () kupiliwa; () kupika; () kupiana; () kupisha. kupindukia excessively: Amelewa ~ He is excessively drunk. kupita than :Yeye ni mrefu ~ mimi He is taller than me. 2 over and above Anafanya kazi ~ kiasi He is working over and above normal
kupua: shake off; throw off. 2 scatter. 3 beat (as with a stick). 4 snatch; take by force. () kupulia; (tdek) kupulika; ()kupuliwa; () kupuana; () kupusha
kurea: kingfisher
kutua: pull hard and suddenly: ~ mkonopull hard the hand. () kutulia; ()kutuliwa; () kutuka; () kutulana; ()kutusha. kutukutu in a circular way; interwiningly. kututu slowly and jumpily; interminglingly
kuuni: (bot) cooly
kwale: francolin; partridge
kwama: be stuck: Gari lime~ kwenyetope the car is stuck in the mud. 2 come to a deadlock; come to an impasse; come to a stand still. 3 get into difficulties; be stranded. () kwamia; () kwamika; ()kwamisha. kwamba that
kwapa: arm pit; axil: tia ~ni tuck it under the armpit
kware: quarry
kwazi: fish
kwima: greed; hist; craving
laana: curse; imprecation; malediction; condemnation
laani: curse; condemn; damn. ()laania; () laaniana; () laaniwa; ()laanika; () laanisha
labda: perhaps; may be; probably. labeka1* (tamko la kuitikia) sir/madam! at your service!
labua: slap; clobber; (michezo) defeat easily; ~ kofi haul off and slap. () labulia; () labuliwa; () labuka; () labuana; () labusha
ladha: flavour; taste
laika: down hair
laiki: befitting: Aliyotenda si ~ yakewhat he did does not befit him
laini: soft; smooth. 2 (muziki) soft music
lalia: sleep on; lie/recline on. Tuta~ godoro leo today we will sleep on a mattress. 2 brood. () lalika; () laliana; () lalisha; () laliwa
lamba: lick: ~ vidole lick finger; ~ kisogo make contemptuous signs behind someone's back. () lambia; () lambika; () lambana; () lambisha; () lambwa; leaf of banana plant; (si rasmi) dodge; evade someone in a game; swerve away: Alim~ kipa na kufunga goli he dodged the goalkeeper and scored. laz.a
lambo: pond; water catchment
landa: resemble. () landia; ()landika; () landana; () landisha; ()landwa
lango: gate; (kanisa) portal. 2 goal; mouth. langu taz. angu my; mine Jina ~ my name; Tunda ni ~ the fruit is mine
laumu: blame. () laumia; () laumiana; () laumiwa; () laumika
launi: colour
legea: be loose: Fundo lime~ the knot is loose. 2 be soft: Ndizi hizi zime~ these bananas are soft. 3 be limp. () legelea; ()legeka; () legeza
lemaa: be crippled / disabled; be deformed. () lemaza
lemba: take by force or by trickery. () lembea; () lembeka; () lembana; () lembesha; () lembwa. lembelembe overripe; overflowing; limp
lenga: aim at; strive for; focus on; drive at. 2 split; slice. () lengea; () lengeka; () lengana; () legesha; () lengwa
lengo: target; object. 2 objective; aim; butt
lenzi: lens: ~ mbinuko convex lens; ~mbonyeo concave lens; ~ ya kuona mbalitelephoto-lens. (Kng)
leuka: sober up. () leukia; ()leukika; () leukisha; () leukwa. levi bibulous; drunk. leviathani * (Biblia) leviathan. (Keb)
levya: intoxicate; go to one's head; Bia hu~ beer intoxicates
lilia: cry for; weep for; bewail; bemoan. () lilika; () liliana; () liliwa
limau: lemon
limba: strike; hit; beat. () limbia; () limbana; () limbika; () limbisha; () limbwa; sink down; be burned. ()limbia; () limbika; () limbisha
limka: be wise; be educated; be clever. () limkia; () limkika; () limkisha
limki: have a defect/deficiency. ()limkia; () limkika; () limkisha. limuzini * limousine. (Kng)
linda: protect; defend; guard; patronize; shield; keep watch.2 fend; conserve; preserve. 3 patrol: ~ zamu guard; be on sentry duty; keep watch. () lindia; () lindika; () lindana; ()lindisha; () lindwa
lindi: cesspool; cesspit; pit
linga: compare; match; harmonize: ~ nguo try on clothes; be measured for clothes. () lingia; () lingana; () lingika; ()lingisha; () lingwa
lingo: pile of wood/timber for sale. lini when: Utakuja ~ ? when will you come? linksi * lynx; wild cat. (Kng) linotaipu * linotype. (Kng)
linta: lintel
lipia: expiate; make reparation for. ()lipika; () lipiana; () lipish.a lipish.al; lipisha; () lipiwa
lipua: explode; blow up. 2 (ms) complete a task. 3 do sth haphazardly. ()lipulia; () lipuliwa; () lipuka; ()lipuana; () lipusha
lisha: feed; nourish; maintain; support: ~ mtoto feed a child; ~ sumu poison sb; ~ mnooverfeed. () lishia; () lishika; ()lishana; () lishwa
lishe: nutrition: ~ bora nutrient
lomba: drum beater (esp. for women dances)
longa: talk; say: () longea; ()longeka; () longana; () longesha; ()longwa
lopoo: offprint
lowea: settle. () lowelea; ()loweka; () lowesha
lugha: language; speech: ~ ya kompyuta computer language; ~ ya kale dead language; ~ ya lung.a kitaalamu professional language; ~ ya kifunditechnical language; ~ chafu/kali strong/bad language; ~ ya biashara lingua franca; ~ ya bubu/kipofu sign-language; ~ ya mitaani slang; ~ ya wenyeji vernacular; ~ ya kwanza/asilimother tongue
lumba: question; argue with; talk/speak badly about sb. () lumbia; () lumbika; () lumbana; () lumbisha; ()
lundo: pile; heap; dump; mound.~ la manyoya ya kondoo fleece; ~ la baruaavalanche of letter; ~ la majani ya ng'omberick
lunga: follow (behind); come after: ()lungia; () lungika; () lungana; ()lungisha; () lungwa
luvea: big horn. M
maada: substance; matter. maadamu* provided; since: ~ umefika tutaanza mkutano since you have arrived we shall call the meeting to order
maafa: disaster; calamity; adversity. 2 misfortune
maana: meaning. 2 reason: Nieleze ~ ya kumpiga mwenzako tell me the reason for beating your friend. 3 aim; purpose. 4 respect; honour; wisdom: Huna ~ you are useless. (ms)Asiyejua ~ haambiwi ~ maasumu don't argue with a fool. crucial; important
maasi: rebellion; revolt; mutiny: ~ ya wanajeshi army mutiny
machi: March. (Kng)
maezi: anchorage
mafua: flu (influenza); chest cold; catarrh; the grippe
maige: young locusts. (Kaj)
maili: mile. (Kng)
maiti: corpse; (tiba) cadaver:chumba cha ~ mortuary; sanduku la ~ coffin; (hadithi) zimwi mla ~ ghoul
maizi: realize; recognize; comprehend. () maizia; () maizika; () maizana; () maizisha; () maizwa
makaa: charcoal; embers: ~ ya mawecoal; ~ mawe yasiyokomaa lignite. 2 fuel
makao: residence; domicile; abode; home; settlement. 2 quarters: ~ makuuheadquarters; ~ makuu ya utengenezaji filamu Marekani Hollywood
makri: trickery and bizzarre doings
maksi: mark(s): Mwanafunzi amepata ~ kumi the student got ten marks. (Kng)
makuu: ostentation; conceit
makwa: notch cut in the top of on upright post to carry a cross piece. 2 pieces of timber put in the bottom of a boat to prevent the boat getting wet from the bilge
malai: cream; milk cream
malau: case; dipute; accusation
mamba: crocodile; (Marekani) alligator; black mamba; fishes' scales
mambo: matters; affairs; thing: ~ ya kale antiquities. 2 (kusalimia) ~ ! hi!; stake; peg. mamboleo current; neo: Ukoloni ~ neo-colonialism
mamia: intrude on a conversation; interrupt. 2 cry with a loud hiccup. () mamilia; () mamika; () mamiana; () mamisha; () mamiwa; hundreds
manda: small oval rice bread
mando: red patch on the baboon's buttocks
mangi: chief of the Chaga. mangi
mango: hard; black; rounded stone used for pounding or smoothing
manii: semen; sperm
manja: Pemba white-eye (bird)
manju: maestro
manya: know; understand. ()manyia; () manyika; () manyana; ()manyisha; () manywa
manza: mistake; error; offence. 2 conflict; dispute
maoni: comment(s); remark; view
maono: image
masua: giddiness; diziness
masuo: ejected water after rising mouth
mauja: danger; agitation; misfortune; miracle(s); wonder(s)
mauko: departing; departure; death
maume: carved decoration in front of a vessel e.g. a boat
mauti: death; demise
mauzo: sales; marketing
mawio: sunrise; dawn
mbabe: brute; strongman; giant person. 2 hero; movie star
mbali: far; afar. not right; different; aloof: Shati hili lina rangi~ na lile this shirt has different colours from that one. for a long time. (ms) Achilia ~ leave it alone; it doesn't matter. mbalimbali* various; different; assorted
mbano: squeezing. 2 cleft stick
mbari: clan; family line; lineage
mbasi: friend
mbata: giddiness
mbega: colobus monkey; colobus monkey hair
mbege: finger millet. 2 finger millet brew
mbegu: seed(s). 2 germ
mbeja: smart and stylish woman
mbele: infront; front. before:Kati yenu nani aliyekuja ~ amongst you who came ahead. 2 in public: Alimtukana ~ ya watuhe insulted him in public/in front of people. 3 in future: Huna ~ wala nyuma you are poor; genitalia
mbera: outrigger
mbeya: talebearer; gossip; scandalmonger
mbezi: scornful person; proud/supercilious person. mbi bad: Mila ~ bad customs
mbibo: cashewnut tree. (Kre)
mbini: forger
mbinu: double jointed curve: Ana mikono ya ~ she has double jointed hands; method; strategy; tactic; device. 2 trick: ~ ya kujihami kwa miguu na mikono karate
mbiru: income tax. (Kaj)
mbiya: seedling: Tia ~ transplant seedlings
mbizi: dive: Piga ~ dive; Maji ya ~ deep water
mboga: pumkin plant; vegetables. 2 relish; side dish. mboga3 weak. 2 soft; cheap
mbogo: buffalo
mboji: humus; composit
mbojo: killer in lion's skin
mboko: small gourd for drinking water or local brew
mboni: pupil; apple of the eye. 2 special gift. mbungu
mbono: castor-oil plant
mboza: tree with star shapped fruits and rope producing bark; small insect that makes honey and wax
mbuba: skin disease causing sore and sole cracks. mbubujiko mi- bubbling up
mbuda: fighting stick; money
mbuga: grassland; savannah; campaign; lea: ~ ya wanayama game reserve. mbuge nibbling: Mtu ~ nibbler
mbugi: tinkle bells
mbuji: authority (in a certain field/subject). 2 elegant; well dressed person
mbuku: miser
mbulu: insane person; feeble minded person; insanity; madness
mbuni: coffee tree; ostrich
mbura: yellow flowered tree bearing brown fruit; small brown; edible fruit
mbuta: gift; present. 2 part of bride wealth
mbute: boiled and dried sweet potatoes
mbuya: friend; comrade. 2 concubine
mbuyo: techinique of sailing in bad weather
mbuyu: baobab tree
mbuzi: goat: dume he goat; mwituibex; coconut grater
mbweu: belch; burp: Piga belch
mchai: tea tree; tea bush
mchoo: light rain season between July and October in East Africa
mchwa: white ant; termite
mdadi: excitement; willpower; drive
mdaku: snoop; slanderer; tale bearer
mdeke: ramrod
mdela: brass or copper coffee-pot
mdeni: debtor
mdimu: lime tree. (Kih)
mdogo: junior
mdomo: lip; beak; bill. 2 mouth; (zamani) gob: Alitia nyama ni he put the meat in his mouth. 3 opening (e.g. bottle; sack). (ms)mrefu isolence; Ana mchafu he/she is abusive.(nh) Tia interrupt a discussion; interject; Funga wako shut your gob; Kinanda cha hormonica; mouth organ
mdoya: spy. 2 sponger
mdudu: insect: wa kidoleniwhitlow
mechi: match. (Kng)
memba: member: (Kng)
membe: whimbrel: ~ mweusiganner
mende: cockroach; beetle. 2 sodomite
menya: peel; strip away; shell. ()menyea; () menyeka; () menyana; ()menyesha; () menywa
mfano: example; instance; parable:Kwa ~ for example; ~ halisi epitome; classical example. 2 model; pattern
mfiwa: bereaved person: haki ya mke ~ dower
mfiwi: lima bean plant
mfuko: bag. 2 pocket. 3 fund: ~mdogo wa kutia saa fobs; ~ wa bastola holster
mfume: white barked straight tall tree
mfumo: style of weaving. 2 system:~ wa kuhawilisha fedha/mali giro
mfupa: bone
mfuru: black berry tree
mfuto: sth plain: Mlango wa ~plain door without carving or ornamentation; (karata) loose five times. 2 (kamari) lose all money
mgawo: division: ~ wa sehemu mbili/mwainisho wa mwili dichotomy
mgazi: mi oil palm tree
mgema: palmwine tapper
mgemo: method of tapping trees
mgeni: stranger; foreigner; alien. 2 guest; visitor: mgongo ~ wa heshima guest of honour. mgeuko wa
mgobo: quarrelsome person; fan; devotee
mgodi: mine
mgoli: python like water snake; wife of a traditional ruler; e.g. chief
mgomo: strike: ~ baridi goslow; slowdown
mgoni: adulterer; formicator
mgono: kind of fish trap
mgoto: elephantiasis; bang
mgoza: fire strinking tree
mgude: white barked tall sleepery tree
mguno: muttering; grumbling
mguso: special part of the body touched by opponent to indicate that he/she has caught his/her opponent. 2 way of touching. 3 touch: Hotuba yake ilikuwa na ~ mkali kwangu I was touched by his speech
mguto: bawling
mhasi: castrated man or animal
mhina: henna plant
mhoji: interviewer
mhopi: hop. (Kng)
mhoro: sharp stake in pit for trapping game
mhuni: unmarried person. 2 idler; vagrant. 3 outcast. 4 hooligan
mhuri: rubber stamp; seal. 2 stamp chop. (nh) piga ~ certify; pata ~ be approved; ~ wa ithibati imprimatur
miadi: date; promise; appointment
milia: zebra crossing
milki: realm; kingdom. 2 estate
mimba: pregnancy: Kuchukua ~gestation; Tunga ~ conceive; become pregnant; Tia ~ impregnate; Toa ~ abort
mimea: plants: ~ yote ya kipindi fulani au nchi fulani flora; ~ ya misitu herb. mimi kw I; me
mindi: duiker. mithili minghairi* except; without
minya: pinch; squeeze (out). ()minyia; () minyika; () minyana; ()minyisha; () minywa
miraa: type of stimulant herb. miraba minne foursquared; square shaped:Mtu wa ~ sturdily built person
miski: black powder for making ink or perfume; musk
mjaji: comer; arrival (person)
mjali: lamp's wick
mjane: widow; widower. 2 unmarried person; bachelor; spinster: ~ wa kike mrithi dowager
mjiko: haemorrhoids
mjima: member of a communal working team
mjoho: relvet apple-tree
mjoja: tree used to make canoes. mjoli
mjoli: descendant of a freed slave
mjuba: know all person; arrogant person
mjume: skilled person in engraving or inlaying
mjumi: aesthete; esthete. ujuminm aesthetics
mjumu: maker of knives. 2 big knife without a handle
mjusi: lizard; illness that causes the nose to bleed
mjuvi: impudent person
mjuzi: well informed person; experienced person
mkadi: screw pine
mkaka: hard wood tree with a black pith
mkale: ancient person; founder of a clan; old person who knows many things of the past. 2 senior citizen. 3 conservative person
mkama: customary ruler in some parts of the Great Lakes
mkasa: event; happening usu bad. 2 unusual happening/event; unusual act usu mkebe comic; adversity
mkasi: pair of scissors
mkata: poor person; destitute
mkate: bread: ~ mdogo wa mviringo bun; M~ mtakatifu Host. 2 tobacco cake; plug
mkato: cutting; incision; amputation; cut. 2 short; decisive action/speech:Sema kwa ~ say in brief. 3 crosscut: Njia ya ~crosscut; coma
mkaza: wife of: ~ mjombauncle's wife
mkazi: inhabitant; resident
mkazo: force; tension; exertion. 2 stress; emphasis
mkebe: can; canister; cigarette case
mkeka: mat: ~ wa kiwambazaniarras
mkiki: vehemence
mkiwa: orphan. 2 lonely person; loner. 3 fellowless person
mkizi: cuttle-fish
mkoba: pouch; bag. 2 medicineman's bag: Kifungua ~ initial consultation fee
mkodi: tenant; renter
mkojo: urine: Ugonjwa wa ~(tiba) diuresis
mkoko: red barked mangroove. (ms) Ndio kwanza ~ ualike maua it is just the beginning (of things)
mkola: (mimea) cola; kola:Matunda ya ~ kolanuts
mkole: tree with small edible fruits; fibre of which is used to produce soapy substance for washing hair etc; branch of coconut palm. 2 stalk of fruits
mkoma: hypheene/dwarf palm; lepper. 2 mkomafi (ms) witch killer; oppressor. (mt) Asiye ~ hujikoma mwenyewe one who has no assistance should self assist
mkomo: kind of powdered charm believed to cause sb to faint
mkoni: pine tree
mkono: arm. 2 hand; handle. 3 branch of river; creek of sea. 4 cubit; half yard. (ms) () Ana ~ he/she is a thief; (2) Ana ~ mzurihe/she has nice handwriting; he/she is dexterous; (3) Ana ~ mbaya he/she is clumsy; (4) Ana ~ mzito he/she is slow; (5) ~ wa bahari lough
mkopi: borrower. 2 knave
mkopo: credit; hire purchase. 2 loan
mkora: scoundrel; rascal; hooligan; crook
mkosi: bad omen; jinx
mkota: sweet stalked sorghum; strong person
mkowa: money belt
mkufu: chain; necklace
mkugo: debt
mkuki: spear: ~ shoka halberd; Askari anayetumia ~ shoka halbedier. 2 (michezo) javelin: Kutupa ~ javelin throw. mkukini
mkuku: keel of a boat or ship
mkulo: coconut strainer
mkuno: scratching; scraping; grating
mkupi: type of yellow fish living in estuaries
mkure: black/gray eel
mkusi: bird tail
mkuyu: wild fig tree
mladi: weaving stick
mlafi: glutton; gourmand
mlaji: consumer; good eater
mlala: hyphaene; dwarf palm
mlale: soot
mlama: type of tree used as anti-vernom
mlamu: brother in law/sister in law
mlasa: red white pink flower
mlaso: dish made of blood mixed with sour milk
mlele: tail feather: ~ wa jogoo a cock tail feather
mlete: seam in a sail. mlingoti
mlevi: drunkard; alcoholic; drinker: ~ wa madawa ya kulevya junkie; junky
mlezi: guardian; custodian; baby's swinging cot; tonsillitis; swollen neck glands
mlifi: payer
mlima: mount; mountain: ~ Kilimanjaro Mount Kilimanjaro; ~ mrefu alp
mlimi: talkative person; wordy person; verbose speaker. 2 narrator
mlimo: way of clearing a field and growing crops
mlipu: type of anti-inflamatory plant
mliwa: tree with a fragrant aromatic wood
mlizi: cry baby. 2 bereaved woman
mlozi: almond tree; wizard; sorcerer
mluzi: whistle
mmaka: frangipane-tree
mmbea: gossip; tell-tale; scandalmonger
mmego: bite; cut piece. 2 biting; cutting. mmeng'
mnada: auction: Piga ~ make an auction
mnadi: auctioneer. 2 announcer; (Uislamu) one who calls to prayers
mnamo: sea vessel edge. mnamo2 on; at: ~ saa saba mchana at one p.m
mnana: golden weaver finch; yellow dye used for staining leaf-strips for making mats
mnara: tower; lighthouse; steeple; minaret; belfry: ~ wa saa clock-tower; ~ wa kengele campanile
mnaso: holding fast; trapping; sticking together
mnato: adhesion
mnavu: type of sour tasting leave plant used as vegetable
mnazi: coconut palm
mneni: eloquent person; professional orator
mnepo: flexibility; malleability; elasticity
mneso: suppleness; flexibility; plasticity. mng'
mnofu: boneless meat; steak. (ms)Uking'wafua ~ ukumbuke na kuguguma mfupa whenever you are in happiness remember that there are unhappy times as well; Kipande cha ~ escalope
mnoga: dried tobacco leaf; nose-bleeding
mnuko: malodor; stench; stink; fume
mnuna: younger brother/sister. Mnung'
mnuni: sulky person
mnuno: grumbling; sulkiness; discontent; complaint
mnyaa: dwarf palm whose leaves are generally used for making mats; baskets etc
mnyeo: itching sensation; prickling; ticking
mnyoo: mi worm: ~ bapa (katika ini la kondoo) fluke
moshi: smoke. 2 steam: Gari la ~locomotive; illicit gin. mosi first: Mei ~ May Day
mpaje: sweet millet straw
mpaji: giver; benefactor; bestower; provider: ~ ni Mungu God is the bestower. mpaka1 until; to; up to: Hapa ~ kule here up to there
mpaka: border; boundary; frontier: Ugomvi wa mpakizi ~ frontier disputes
mpako: coating
mpasi: one who acquires things or wealth easily i.e. without problems; enemy; antagonist
mpera: guava tree
mpesi: tree whose bark is used to strengthen and dye fishing belt
mpeta: cloves which have fallen from a tree
mpigo: blow; stroke; thrust; beat
mpiko: stick or pole to carry or sling loads on. 2 lever
mpini: handle: ~ (hasa wa shoka) helve
mpira: rubber tree. 2 rubber. 3 ball. 4 football: ~ wa miguu football; ~ wa wavuvolleyball; ~ wa pete netball; ~ wa maji hose; ulimbo wa ~ later
mpito: transition: Kipindi cha ~ transitional period
mpoto: twisting of rope
mpupu: cowitch bean plant
mraba: row: Nimemaliza kulima ~ mmoja I have finished tilling one row; square: Kilometa ~square kilometre; candy bar; right angled triangle. pembetatu
mradi: intention:Nimesumbuka bure sikupata ~ wangu I laboured for nothing I did not succeed as intended. 2 project; programme; provided; so long as: Si kitu ukinyamaza ~ ufike mkutanoni it does not matter if you keep quiet provided you come to the meeting; spindle
mrela: loose shirt or robe
mrera: red silk ornamental stiching on the neckline a woman's robe
mriba: sweet potato leaves; cowleg
mrihi: bear pod tree
mrija: pipe; tube; reed. 2 exploitation
mrima: East African Coastal strip. 2 Winde/Mbwamaji area of Tanzanian coast
mrina: ~asali honey gatherer
mrisi: less than minimum score in a card game
mriti: bean pod tree
mroho: greedy; avaricious or cavetous person. mronge
mruko: jump; flight; gambol
msafa: line; queue; file
msago: milling of grain; sexual act between lesbians. msagunda haphazard; random; disorderly
msaha: poker; crowbar
msaji: teak tree
msako: hunt; search
msala: prayer mat; toilet; lavatory; bathroom; restroom; loo
msana: blacksmith: ~ majembehoe maker
msani: craftsman; artisan
msasa: black thorn; hook thorn. 2 emery paper; sandpaper
msasi: hunter; huntsman
mseja: single/unmarried person; maiden; spinster; bachelor
msemi: speaker
msemo: ~ mkali apothegm. 2 locution; logo
msese: kind of small wader
mseto: dish made from mixture of grains e.g. rice and green grain. 2 mixture; coalition: serikali ya ~ coalition government
msewe: rattle dance. 2 rattle fastened to leg to jingle when dancing. 3 kind of large drum
msiba: bereavement; sorrow; misfortune; disaster. (ms) Hakuna ~ usiokuwa na mwezi misfortune never comes singly; ~ mkuucatastrophe
msiga: tooth brush tree
msimo: argot
msimu: season: ~ wa embe mango season; ~ wa mvua rain season
msira: person who boycotts; miser
msiri: confidant. msongo; slow person
msitu: forest: ~ mdogocoppice/copse
msizi: plant used for producing black dye; or black ink
msolo: yellow flowered thorny shrub whose seeds (solo) are used as counters in bao games
msoma: type of women circle dance
msomi: scholar; learned person; educated person
msono: snore
msufi: kapok tree
msuka: spike of a traditional hoe; the part of iron head which is fixed in the handle; plaiter: ~ nywele hair plaiter; ~ mikeka mat plaiter
msuko: style of plaiting
msuli: muscle; men's loin cloth; Misuli ya mkono biceps; ngumu brawn
msusa: type of long headed flat fish
msutu: bed screen. msuuzo
mtaba: dry banana used as tabacco leaf wrap
mtago: laying of eggs. 2 period of laying eggs: ~ huu kuku ameishia mayai saba tu this season the hen had only seven eggs
mtaji: capital. 2 counters in a type of board game
mtaka: one who wants sth
mtala: one of the wives in a polygamous marriage: Ndoa ya mitalapolygamous marriage
mtale: very sharp knife
mtali: bangle; anklet
mtama: sorghum plant. 2 sorghum seed
mtani: person in a joking relationship
mtapa: reed
mtapo: type of cyead; shivering; trembling; quivering from cold/fear/illness; ore
mtaro: trench; ditch
mtata: fibrous plant usu used for making prebrands
mtawa: nun; monk; hermit. 2 stay-at-home; someone in seclusion. 3 friar
mtego: trap; snare. 2 trick played to get sth; obedient/submissive/dutiful person. mtikisiko
mteja: client; customer. Mteka
mteke: delicate/young person. 2 coward; milksop
mtema: judge; magistrate. Mtema
mtemi: chief; ruler. 2 tyrant; ruthless person
mtemo: cut; cutting
mtepe: sailing-vessel with a long projecting prow; upright mast and a square matting sail
mtesi: backbiter. 2 hostile/provocative person; persecutor
mtima: heart
mtini: fig tree; clown; buffoon
mtiti: type of owl
mtoki: inflamed gland; bubo
mtomo: reinforcing plaster work with small stones
mtori: green banana soup
mtoro: runaway; truant
mtoto: child; (Kiskoti) bairn. 2 young person. 3 wa jicho cataract. 4 inset: wa meza table drawer. 5 juvenile. (nh) wa watuwell-born person; wa sungura leveret; wa batamaji cygnet; wa kike daughter; wa paa fawn; mchanga infant; Iba kidnap a child; Mwizi wachild kidnapper; wa paka kitten; Mavazi namahitaji mengine ya ~ mchanga layette
mtule: destitute
mtume: apostle; disciple; prophet
mtura: thorny wide-leaved plant bearing small round yellow fruits when ripe
mtutu: gun muzzle; barrel. (ms)Kwa wa bunduki by force of arms
mufti: doctor of Islamic law. 2 professor; pleasing; elegant; stylish
mumbi: bittern (large bird which makes a noise like a drum)
munda: big harpoon; piece of planking used in wooden construction; e.g. in constructing vessels
mundu: sickle; bill-hook; cutlass
mungu: God; Deity; Jehovah: Mwenyezithe Deity. divine; idol: wa mashambani mwenye pembe na miguu ya mbuzi faun; miungu ya masanamu fetish. mung'
munyu: salt
murua: good habit/character; honourable; respectable; nice; pleasing; elegant: Ni mtoto he/she is a nice kid
muuza: salesperson; seller: duka(la vyakula na bidhaa ndogondogo) grocer. ji nguo haberdashar
muwaa: hyphaene or dwarf palm
mviga: offering; propitiatory offering
mviko: act of performing ritualistic offering to appease ancestors
mviru: common wild medlar
mvita: (zamani) Mombasa
mvivu: lazy person; idler
mviza: evergreen tree used in rituals and medicine
mvuje: asafoetida. 2 gum of asafoetida
mvuke: vapour; steam
mvuko: crossing
mvule: iroko
mvuli: boy; male youth
mvumo: roar; flurry; deleb palm
mvure: wooden bowl. mvurugano
mvuto: attraction. 2 pull
mvuvi: fisher; fisherman
mwaga: ele pour out; spill. () mwagia; () mwagika; () mwagana; ()mwagisha; () mwagwa
mwago: gift given by a man to his wife on the eve of marrying another wife
mwaka: year
mwako: heat. 2 flame light; blazing; burning; plastering; white washing of a wall or building
mwale: raffia palm; soot; ray; beam; flame
mwali: maid; girl of marriagable age
mwana: child; off spring; a title before a woman's name e.g. Mwanahamisi; Mwanahawa
mwani: sea weed; alga; kelp
mwari: person in seclusion esp an initiate. 2 virgin. 3 bride or groom during honeymoon; pelican
mwasi: rebel: Askari ~ insurgent
mwata: worms (dug out on the beach and used as mwendeshaji bait)
mwayo: yawn
mwega: support; prop
mwehu: (wehu) - lunatic; insane person; mentally ill person
mweka: twinkle; flash: () mwekea; () mwekeka; () mwekesha; ()mwekwa. mweka
mweni: (weni) - guest; visitor; stranger
mwere: wild kapok tree
mweuo: high tide; Purification Day. 2 cleansing of the body
mwewe: falcon; hawk; kite; brown black striped wide fish
mwezi: moon. 2 month: ~ kongo/mwandamano/ mchanga new moon; ~mkuu/mpevu full moon
mwiba: miba - thorn. 2 sharp bone. 3 prickle
mwigo: imitation; large dove used for travel prediction
mwiko: wooden spoon: ~ wa mwashi mason's trowel; harmful thing. 2 taboo; totem
mwiku: leftover food
mwili: body. 2 main colour of a material
mwima: sb who likes standing; group of women who arrange a funeral
mwimo: pillar. 2 door/window frame
mwina: trap hole/pit
mwiro: elephant trunk
mwito: call; appeal
mwivu: jealous person. 2 envious person
mwiwa: debtor
mwiza: depth enough for anchorage
mwizi: (wezi) thief
mwoga: coward
mwogo: bath. 2 bath day of initiates
mwovu: evil person
myeka: Katibu ~ confidential secretary
mzaha: joke; ridicule; derision; fun: Fanya ~ make fun of
mzawa: indigenous person; native
mzazi: parent. 2 fertile person. 3 woman in childbirth
mzega: yoke; pole carried across shoulders for carrying two equal things. 2 measure of two tins carried by such a pole
mzibo: plugging
mzigo: load; luggage. 2 burden; heavy responsibility
mzimu: spirit worship place. 2 ancestral spirit; dead person's spirit; white dust/soil
mzira: baracouta
mzizi: root
mzoga: carcass; corpse; dead body
mzozo: argument; dispute; squabble
mzuka: spirit
mzuko: sudden appearance
mzuza: one who can find cause of a disease by using traditional prognosis. 2 one who can seek and find witchcraft
mzuzu: plantain. N na1 and. 2 with. 3 by: Juma ~ Maria wameondoka Juma and Mary have left; Juma amekwenda ~ Maria Juma left with Mary; Juma amepigwa ~ Maria Juma was beaten by Mary
nabii: prophet
nachi: belly dance
nadra: scarcity; rarity: Juma huja hapa kwa ~ Juma rarely comes here. rare; scarce
nafsi: soul; spirit. 2 self. 3 essence
nafuu: profit; gain; progress; assistance. 2 convalescence; improvement in health. (
nahau: idiomatic expression; idiom
naibu: deputy
naima: ecstasy
namba: number. (Kng)
nambo: <
namna: type; kind; way: ~ kwa ~ of various kinds. (Kaj)
namua: save counters (in a game). 2 disengage; dislodge. () namulia; (tdek)namulika; (tdes) namulisha; () namuliwa
nandu: morning star
nanga: anchor. (Kaj) nang'
nanua: widen; force apart. ()nanulia; (tdek) nanulika; (tdes) nanulisha; () nanuliwa; () nanuana
nasua: set free from a trap; untrap; unhook. () nasulia; () nasuka; ()nasuana; () nasusha; () nasuliwa
nauli: fare
nauni: sleep; slumber
nazaa: contempt
ndago: nut grass: ~ mwitu papyrus
ndama: calf
ndani: inside; within: Geuza/Pindua nje ~ turn inside out
ndara: plain leather sandal
ndaro: boast; brag; vaunt
ndaza: brew left to ferment
ndege: bird; aeroplane
ndeme: bad uncookable green gram
ndere: powder used as a love charm or by magicians during hypnotism
nderi: large long billed black bird of prey
ndewe: earlobe. 2 pierced earlobe. (ms) Hanihusu ~ wala sikio he/she is none of my concern
ndezi: kind of big rat. ndi full to the brim. 2 forcefully
ndiga: tuber rooted thorny shrub
ndimu: lime. ndiyo yes; yeah
ndiva: gully; pool
ndizi: banana
ndobe: type of catfish
ndoto: dream
ndovi: cooked green plaintain
ndovu: elephant
ndubi: strut (in a vessel)
ndude: thing
ndugu: kin; sibling. 2 relative. 3 close friend. 4 comrade
nduli: two headed snake. 2 hypocrite. nen.a <
ndume: strong person; unhusked rice
ndumo: inspiring call. 2 counsel
nduni: wonder; novelty. 2 characteristic. ndururu1 small
ndusi: box
ndweo: arrogance; pride; boastfulness; conceit
neema: grace; bounty; affluence; comfort
nembe: type of tilapia
nembo: emblem; tattoo. 2 trademark
nemsi: honour; good name
nepua: bend; swing. () nepulia; ()nepuka; () nepusha
ngabu: gouge
ngadu: type of crab
ngagu: type of changu fish. ng'
ngama: hold of vessel; white clay; faeces passed in extremis. ng'arish.a < ng'
ngano: fable; tale; story; wheat
ngara: male maize flowers; skin worn by a chief during a ceremony. ng'
ngawa: civet cat
ngazi: ladder. 2 step; stairs. 3 post
ngebe: useless talk; bitching. ngebe2 talkative person
ngeda: green locust
ngegu: red ochre
ngeja: plaque
ngeli: noun class
ngiri: wild-boar; wild-pig; hernia
ngisi: cuttlefish
ngizi: unfermented coconut drink. ng'o! never!
ngogo: catfish
ngoja: wait. () ngojea; ()ngojeka; () ngojana; () ngojesha; ()ngojwa
ngoko: red spot on monkey's behind
ngole: long green snake; bow's rope
ngoma: drum. 2 dance. ng'
ngome: escarpment. 2 fort; fortress; stronghold. 3 defence (in a game). ng'
ngono: wife's turn to sleep with a husband in a polygamous marriage. 2 intercourse; sex. ng'
ngosi: wildebeest; topi; gnu
ngoto: closed fist
ngozi: skin; hide; leather
nguli: hero; champion; brave man. 2 restless person. 3 adult
ngumi: fist
ngumu: (ms) wekea ~ deny sb sth; refuse sb sth
nguri: shoe maker's mallet
nguru: kingfish
nguta: dried coconut
nguva: mermaid; dugong; manatee
nguvu: force; strength; power. 2 authority; supremacy. 3 impetus; pressure; solidity
nguyu: knuckle; ankle
nguzo: post; pole; buttress. 2 pillar; fundamental principle. ngwa ka somebody's: Mwana~ somebody's child; Kiti~ somebody's chair. ng'
niaba: behalf: kwa ~ ya on behalf of; Amekwenda kwa ~ yao he went on their behalf
ninga: green pigeon. ning'
ningu: broad; spiked fresh water fish. nini kw what?
nisha: starch
njama: conspiracy; plot
njana: type of red snapper
njano: yellow
njeku: bull
njeli: bow
njiti: matchstick; premature baby
njiwa: pigeon; dove: ~ mangadomesticated pigeon. njongwanjongwa (kutembea) softly with stealthy steps as if following sb secretly. njoo! come!
njozi: dream: Mfalme ~ diviner; forecaster
njuga: ankle bells. (nh) Valia mtu ~pursue sb/sth persistently
njugu: peanut plant; groundnut plant: ~ mawe bambara nut
njumu: silver nails. 2 shoe cleats
njuti: leather boat. (Khi)
nmizi: warrant. (Kng)
noeli: Christmas
nokoa: assistant field supervisor. 2 farm guard. (Kaj)
nondo: moth; enormously long and big snake (about one metre long); steel bar: ~ za dirisha steel window bars
nonga: make angry; annoy; exasperate. () nongea; () nongeka; () nongana; () nongesha; () nongwa
nongo: body dirt. 2 bad luck. nong'
nuiza: make a wish; pray. () nuizia; () nuizika; () nuizwa
nukia: smell nice. () nukilia; ()nukika; () nukiana; () nukisha; () nunuz.a nukiwa
nukta: full stop; point. 2 second (of time)
nukuu: transliterate; transcribe. 2 quote. () nukulia; (tdek) nukulika; ()nukuliana; (tdes) nukulisha; () nukuliwa
numbi: blue lined round short fish
nunda: semi-wild cat. 2 big and strong person. (ms) ~ mla watu man eater
nundu: hump; bat
nunge: leper settlement. 2 finger stumps; zero; nil: Wamefungwa magoli matatu kwa ~ they conceded three goals to nil. nungu1
nungu: sweet red fish; ruffled feathered hen. nung'
nunua: buy; purchase. () nunulia; (tdek) nunulika; (tdes)nunulisha; () nunuliwa; () nunuana
nyago: legs; thighs. 2 pace; step; stride: Humwezi kwa mwendo; ~ zake ndefuyou can't beat him; he has long strides
nyaka: catch; snatch. () nyakia; () nyakika; () nyakana () nyakisha; () nyakwa. nyana <; beat; slap; box sb's ears.()nyakia; () nyakika; () nyakana; ()nyakisha; () nyakwa
nyama: meat. 2 flesh. (ms) ~ ya ulimi sweet words
nyana: arrow's or spear's head. nyanda <
nyani: baboon
nyapa: sneak along; stalk; move stealthily. () nyapia; () nyapika; ()nyapisha; () nyapwa
nyara: kidnapper; highjacker; plunderer; captive; booty; spoil. 2 trophy: ~ za serikali government trophies. nyara2 cheap; free
nyasi: grass
nyata: sneak along; stalk. () nyatia; () nyatiana; () nyatika; () nyatisha; () nyatwa
nyati: buffalo
nyato: nipple
nyayo: foot prints; sole; footsteps:Fuata ~ follow in footsteps of; (Kenya) philosophy that emphasizes peace; love and unity
nyege: erotic stimulation; lust; sexual desire: Tia ~ stimulate sexually
nyeka: shine; glisten. () nyekea; () nyekeka; () nyekwa
nyemi: happiness; joy: << Sina ~ naye I don't like him/her
nyera: joke; make fun of. () nyerea; () nyereka; () nyerana; () nyeresha; () nyerwa
nyesa: be wet; moisten. () nyesea; () nyeseka; () nyesesha
nyeta: demand attention. () nyetea; () nyeteka; () nyetesha/nyeteza; ()nyetwa. nyeti crucial. 2 sensitive. -nyevu moist; wet; damp; humid. nyie (kifupisho cha nyinyi) you all. nyonda <
nyigu: wasp; hornet. (ms) Kiuno cha ~ a small waistline
nyika: prairies; wilderness; land with scattered trees and high grass. (ms) Alikwenda msitu na ~ he had a long journey; mbio za ~ marathon
nyima: keep back (from); withhold (from); deny. () nyimia; () nyimika; ()nyimisha; () nyimana; () nyimwa. nyiminyimi meanly; tightfistedly; ungenerously.niggardly; miserly. nyimivu mean; tightfisted; stingy. miser; ungenerous. nyinyi kw (wingi) you
nyiza: coloured palm leaf plaited strips
nyoka: snake. 2 worm
nyoko: your mother
nyono: snore
nyota: star. 2 fortune; luck; fate; thirst
nyowe: long multi-coloured grasshopper
nyuka: hit hard; beat hard; thrash: ()nyukia; () nyukika; () nyukana; ()nyukisha; () nyukwa
nyuki: bee
nyuma: behind. 2 past; former
nyuni: bird
nywea: dry up; shrivel up; shrink. 2 be hunched up. 3 lose strength; become weak. ()nywelea; (tdek) nyweleka; () nywesha
nzige: locust
ofisa: officer. (Kng); officer: ~ tawalaadministrative officer. (Kng)
ofisi: office: ~ya Waziri Mkuu Prime Minister's Office
ogopa: fear; be afraid/ fearful. 2 obey:~ Mwenyezi Mungu obey the Almighty God. () ogopea; () ogopeka; () ogopesha; () ogopana; () ogopwa
okoka: be rescued. 2 (dini) be saved. () okokea; () okokeka
okota: pick up. 2 find. () okotea; () okoteka; () okotana; ()okoteza; () okotwa. ondo
ombea: pray for; intercede for. 2 ask on behalf of: Naku~ ruhusa I am asking for permission on your behalf. () ombeka
ombwe: vacuum
omeka: pile up; stack sth up. 2 compress; press; fill. () omekea; ()omekeka; () omekesha; () omekana; () omekwa
onana: meet; see: Ali~ na rafiki yake jana he met his friend yesterday. () onania; () onanika; () onanisha
ondoa: remove; take away. ()ondolea; () ondolewa; () ondoka; ()ondoana; () ondosha
oneza: whisper to. ()nong'onezea; () nong'onezeka; ()nong'onezana; () nong'onezwa. nong'onong'o rumour; gossip
ongea: talk; chat. () ongelea; (tdek) ongeleka; (tdes) ongelesha; () ongelewa. onge.a2 increase. () ongewa
ongoa: reform; convert; set right. 2 soothe a child by soft songs. () ongolea; () ongolewa; () ongoleka; ()ongoana. ongofu converted; reformed
onyea: be weak/ languish/weary. 2 be uncomfortable. ()nyong'onyelea; () nyong'onyeka; ()nyong'onyeana; () nyong'o-nyesha
ororo: soft; smooth: Ngozi ny~ smooth skin; Muziki mw~ soft music
otama: squat. () otamia; ()otamika; () otamisha. -o-ote any: Una kitabu chochote? do you have any book? -ote all; whole; entire: Watu w~ all people; Vitabu vy~ all books; shule ya~ the entire school
oteza: pray vehemently. ()gong'otezea; () gong'otezeka; () gong'otezana; () gong'otezesha; () gong'otezwa. gong'
paaza: (nafaka) grind; pound (with a pestle or mortar). () paazia; () paazika; () paazisha; () paazwa
pacha: twin: ~ fanani identical twins. adherent; clustered; compatible; sticking together: Ndizi ~ banana clusters; congruent triangle. pembetatu
padri: priest; clergyman. (Kre)
pagaa: carry (e.g. a load) on head or shoulders. () pagaza; be possessed by an evil spirit. () pagalia; () pagaza; () pagawa
pagao: charm against evil spirit; talisman
pagio: tree cuts for climbing
pagua: change route to avoid sth. ()pagulia; () paguliwa; () paguka; ()pagusha
paguo: diversion; detour
pagwa: tip of a pole used as a rafter in constructing roofs of native houses
paipu: siren; horn
pakia: load; load on to; embark. ()pakilia; () pakiana; (tdes) pakiza; ()pakiwa; () pakika
pakua: unload. 2 dish out; serve food. () pakulia; (tdek) pakulika; (tdes)pakulisha; () pakuliwa. pali.a1 choke; gag on sth. () paliza; () paliwa. pambanu.a
palia: weed. () palilia; ()palilika; () paliliana; () paliliwa
pamba: cotton; packed meal for a travelling; adorn; decorate. 2 arrange; prepare: ~ maiti prepare a corpse for burial. () pambia; () pambika; () pambana; () pambisha; () pambwa; cover; spread. () pambia; () pambika; () pambana; ()pambisha; () pambwa
pambo: decoration; adornment; ornament
pampu: pump. (Kng)
pamvu: betrothal. 2 money paid at betrothal. pamwe together. pana wide; broad
panda: split; parting; fork: Njia ~ cross roads. 2 catapult. pang.a; bugle; forehead; climb; ascend; mount. 2 rise. 3 get upon; ride upon. ()pandia; () pandika; () pandana; ()pandisha; () pandwa; plant; sow. 2 bid. ()pandia; () pandika; () pandana; ()pandisha; () pandwa
pande: disassociation: Piga ~disassociate with; stand aside. pande 2 ma- block; large piece: ~ la mtu giant
pandu: type of large silvery fish
panga: arrange. () pangia; ()pangika; () pa-ngana; () pangisha; ()pa-ngwa; rent: Nyumba ya ~ rented house; house for rent. () pangia; () pangika; () pang.a pangisha; () pangwa; arrange brother-hood/sisterhood. () pangia; () pangika; () pangisha; () pangwa; co-habit. () pangia; ()pangika; () pangisha; matchet; panga; worship lace
pange: tsetse fly
pango: cave; rent. pangu.a disarrange. () pangulia; (tdes)pangulisha; () panguliwa; () panguka; () panguana
pania: bang; collide. () panika; ()paniana; () paniwa. pamoja together: ~ na yote uliyomweleza hakuamini despite all you told him he did not believe it; double up; turn up; fasten up. 2 insist on. () panika; () panisha; () paniwa
panja: forehead. 2 one sided hair cut
panji: type of yello-wish brown kingfish
panua: broaden; widen; stretch. ()panulia; (tdes) panulisha; () panuliwa; () panuka; () panuana
panya: rat
panza: coconut left in the shell after grating. 2 piece of soap left after use
panzi: grasshopper; flying fish. papa1 ~ hapa right here
papai: pawpaw. papara carelessly; hastely
papia: eat/take something greedily: Kula kwake ni kwa ~ he/she eats greedily. ()papilia; (tdek) papilika; () papisha; ()papiwa
papua: enlarge; widen. () papulia; (tdek) papulika; (tdes) papulisha; ()papuliwa
paria: clean up at a betting game. ()parilia; () parika; () pariana; ()parisha; () pariwa
parua: scrape; graze. () parulia; () paruka; () pa-ruana; ()paruza
pasha: red chested grey bird; inform; tell: ~ habari inform. 2 cause to have/get sth: ~ moto warm up. 3 be properly coloured: Hina niliyopaka ime~ henna that I applied is pat.a properly coloured. () pashia; () pashika; () pashana; () pashwa
pasua: split; open. 2 tear: ~ karatasi tear a piece of paper. 3 ake way:~ njia make a path. () pasulia; () pasuka; () pasuana; () pasusha; () pasuliwa
pauka: fan. papatu.a; fade: Sare yake ya shule ime~his school uniform is faded.2 wither. ()paukia; () paukika; () paukisha. paukwa! story! a word used to introduce a story
pauni: pound. (Kng)
pazia: curtain. (Kaj) pe eupe ~ completely white; Shati jeupe ~ a completely white shirt
peasi: pear. (Kng)
pecha: walk lamely. () pechea; ()pecheka; () pe-chesha
pekua: scratch up. 2 brouse; scratch about. 3 walk bare footed. () pekulia; ()pekuka; () pekusha. pekupeku1 barefooted
pelea: prune. () pelelea; () peleka; () pelesha
pemba: East African island North of Zanzibar and near Tanga; deceive; outwit; flatter with fine words. 2 investigate; pry; snoop. () pembea; () pembeka; () pembana; ()pembesha; () pembwa
pembe: vi protractor; horn. 2 trumpet; angle; corner. (ms) ~ za chaki secret place. pembe.a1 pia
penda: love; like.2 will: Amefanya kwa ~ kwake he did on his own will. (ms)M~e akupendae love thy who loves thou. ()pendea; () pendeka; () pendana; ()pendeza; () pendwa
pendo: love
penga: blow one's nose. () pengea; () pengeka; () pepe.a pengesha; () pengwa. pengine perhaps. 2 somewhere else: Hapa hawauzi mafuta jaribu ~ they do not sell oil here; try somewhere else
pengo: gap; notch; vacant place:Kifo chake kimeacha ~ kubwa his death has left a big gap
penua: separate; open a little. ()penulia; () penuka; () penusha
penya: penetrate. 2 pierce. ()penyezea; () penyezeka; () penyezana; () penyezwa
penzi: love
pepea: fan. 2 blow; wave: ~ benderawave on flag. () pepelea; () pepeka; ()pepesha; () pepeana; () pepewa; fail to develop fully. ()pepelea; () pepeka; () pepesha; ripen fruits artificially. ()pepelea; () pepeka; () pepeana; ()pepesha; () pepewa
pepua: winnow; sift. () pepulia; () pepuliwa; () pepuka; ()pepuana; () pepusha
peteo: kind of roundish utensil like a winnowing basket
petua: turn upside down; overturn. 2 inside out (e.g. shirt or cloth). ()petulia; (tdek) petulika; () petuliwa; ()petuana; () petusha. pevu mature; grown up: Mtoto pevu.a wake amekuwa m~ her child has grown up. 2 be ripe: Embe ~ a ripe mango
pevua: force to mature: () pevulia; () pevuliwa; () pevuka; () pevusha. pewa astray; sideways; off course: Enda ~ go sideways; go astray/off course
piano: piano. (Kng)
picha: picture; photo-graph: Piga ~take photographs; Chora ~ draw a pi-cture. (Kng)
pigia: hit with; hit because of sth; hit/beat on behalf of sb
pilau: pilaf. (Kaj)
pinda: fold; bend. 2 sew a hem: ()pindia; () pindika; () pindisha; ()pindana; () pindwa
pindi: piece of sth cut from sth: ~ ya mua a piece of sugarcane; ~ ya mkono part cut from an arm; time; moment: ~ alipoingia the mo-ment he entered; ~ alipo-ondoka walifika the moment he left they arrived. 2 even through: Tutaonana ~ mwakani we will meet next year
pindo: hem: ~ jembamba a slim hem; ~ nene a big hem. pindu1 word used to emphasize the overturn:Pinduka ~ over-turn completely. pindu2 overturnable; turnable
pinga: block; bar; obstruct. 2 oppose; contradict. 3 bet. () pingia; () pingika; () pingana; () pingwa
pingo: earplug (worn by women); barrier; pingu obstruction bar e.g. a door bar
pingu: handcuff; fetter. 2 loop/noose used when climbing a tree especially a palm tree. (ms) ~ za maisha marriage bonds
pisha: let sth/sb pass; give way: ()pishia; () pishika; () pishana; ()pishwa; sharpen. 2 mark with a hot iron. () pishia; () pishika; () pishana; () pishiza; () pishwa. plasta
pishi: measure of 5 kilos used for measuring grain
pisho: scar or mark caused by hot piece of iron
pitia: pass by/at/near. 2 make a brief visit. () pitilia; () pitika; () pitiana; () pitisha; () pitiwa
pitio: critical review
pitua: turn inside out. overturn. () pitulia; () pi-tuka; ()pituana; () pitusha
plagi: plug. (Kng)
plani: plan. (Kng)
pochi: purse; wallet; pouch. (Kng) pochi2* ma- wide bangle/ bracelet. (Kaj)
podoa: put on cosmetics; make- up. () podolea; () podoleka; () podoana; () podolesha; () podolewa. pofu1 blind
pofua: cause blindness. 2 bleed. ()pofulia; () pofuliwa; () pofuka; ()pofuana; () pofusha
pogoa: prune. () pogolea; (tdek)pogoleka; (tdes) pogolesha; () pogolewa; () pogoka; () pogoana
pogoo: tree branch
pojaa: deflate; shrink. () pojalia; (tdek) pojalika; () pojaza; () pojawa
pokea: receive. 2 meet/ welcome somebody: Alitu~ kwa furaha she welcomed us happily. () pokelea; (tdek) pokeleka; ()pokelewa; () pokeana; () pokesha. poko! expression of contempt
polea: work as a casual labour. ()poleka; () polesha. polio* polio. (Kng)
pombe: local brew; beer
pombo: type of slippery vegetable
pomoa: calm; placate: Alikuwa na hasira nyingi lakini nimem~ he was very angry but I have calmed him. 2 knock down a pile of things. () pomolea; (tdes) pomolesha; ()pomolewa; () pomoka; () pomoana. pomoni pomoni brimful
ponda: pound; crush; mash; smash; crash. (nh) ~ mali squander money; waste resources. () pondea; () pondeka; ()pondana; () pondesha; () pondwa
ponoa: bark. () ponolea; (tdek)ponoleka; (tdes) ponolesha; () ponolewa; () ponoana
ponuo: stripping off. popot.a
ponya: cure; remedy; heal; cure. () ponyea; () ponyeka; () ponyana; ()ponyesha; () ponywa
ponza: endanger; put at risk; jeopardize. () ponzea; () ponzeka; () ponzana; () ponzesha; () ponzwa; sth that endangers/jeopardizes sb
pooza: paralyze. 2 (tunda) be withered and taste-less. () poozea; () poozeka; () poozesha; () poozwa; something withered or arrested in growth (esp of fruits)
popoa: knock down a fruit with a stone or a stick. 2 throw sth e.g. a stone with an aim of hurting sb. () popolea; (tdek) popoleka; (tdes) popolesha; () popolewa; ()popoana
popoo: areca nut
posho: allowance: ~ ya jamalaentertainment allowance; ~ ya kujikimusubsistence allowance; potok.a ~ ya majukumu responsibility allowa-nce; ~ ya takrima hospitality allowance; ~ ya usumbufudisturbance allowance. 2 food; ration
posta: post office. (Kng)
posti: post letters or parcels. ()postia; () postiana; () postiwa; ()postika; () postisha. (Kng)
potea: be lost: Kalamu yangu ime~my pen is lost. 2 be wrong; err. (nh) potelea mbali to hell. () potelea; (tdek) poteleka; ()potelewa; () poteana; () poteza. potevu stray: Mwanam~ stray child
potoa: twist; make crooked/curved/slanting. 2 ruin; pervert; spoil:Mipango yetu amei~ he has spoiled our plans. () potolea; () potolewa; () potoka; () potoana; () potosha
pufya: energizing medicine
pujua: degrade; denigrate. 2 deface; render valuelessly. ()pujulia; () pujuliwa; () pujuka; ()pujuana; () pujusha. pukachaka! expression of contempt
pumba: chaff of grain; husk; bran. 2 excretion under the foreskin. 3 food stuck in the teeth
pumbu: scrotum; testicle. 2 hernia; hydrocele
pumua: breathe. 2 find relief; rest. () pumulia; (tdek) pumulika; ()pumuliana; (tdes) pumulisha; () pumu-liwa; () pumuka; () pu-musha; punish because of non- payment of fees in schools. () pumulia; (tdek)pumulika; (tdes) pumulisha
pumzi: breath; respiration
punda: donkey: ~ milia punda zebra; (zamani) anklet worn during enthronment of an Akida. punde soon; in a short while; shortly. (ms) ~ si ~ suddenly
punga: male flower of maize/grass; wave; swing sway. ()pungia; () pungika; () pungana; ()pung.a pungisha; () pungwa; ~ upepo/hewa go out for a rest. () pungia; () pungika; () pungisha; () pungwa; exorcize. () pungia; ()pungika; () pungana; () pungisha; ()pungwa; decrease in heat esp. the sun. () pungia; () pungika; () pungisha
pungu: float of a fishing net; type of skate; type of eagle
punja: cheat/swindle by giving short measure or less than what is due. () punjia; () punjika; () punjana; () punjisha; () punjwa
punje: grain; ringworn
punju: poison made from the head of a black snake; lizard and chameleon entrails
punta: running stitch
punye: ringworn on the head
pupua: strip off leaves by pulling. ()pupulia; (tdek) pupulika; (tdes) pupulisha; () pupuliwa; () pupuana
puuka: get thin. () puukia; ()puukika; () puukisha
puuza: disregard; ignore; snub. ()puuzia; () puuzika; () puuzana; ()puuzisha; () puuzwa
pwaga: polish grain. () pwagia; ()pwagika; () pwagana; () pwagisha; ()pwagwa. pwezu.a
pwagu: cheat
pwaji: foreshore; idle chatter
pwaju: nightjar
pwani: coast; shore
pwaya: be loosefitting. () pwayia; () pwayika; () pwayisha; pound. () pwayia; ()pwayika; () pwayana; () pwayisha; ()pwayiwa
pwaza: boil piece of cassava etc. ()pwazia; () pwazika; () pwazana; ()pwazisha; () pwazwa
pweta: be ashamed; be abashed; be humiliated. () pwetea; () pweteka; ()pwetesha. pwete carelessly
pweza: cuttle fish; octopus
pwita: throb; pulse. () pwitia; ()pwitika; () pwitana; () pwitisha; ()pwitwa. -pya new; recent; modern. 2 novel; strange
pyora: insult. () pyorea; ()pyoreka; () pyoresha. R
radhi: contentment; satisfaction. 2 pardon; apology: Niwie ~ pardon me; I apologize
rajua: expectation; hope; expect; hope
rakaa: (Waislam) bow
ramba: grass skirt; curved knife; lick. (nh) ~ kisogo disregard what sb said by symbolism as a person goes away. () rambia; () rambika; () rambana; () rambisha; () rambwa
ramia: clip of cartridges
ramli: divination; sooth saying: Piga ~read the divining board; divine
ramsa: celebration; merriment. (Kaj)
randa: carpenter's plane. Piga ~plane. (Kaj); plane. () randia; () randika; () randana; () randisha; ()randwa; move around boasting. 2 loiter; wander; walk around aimlessly. () randia; () randika; () randisha
rangi: colour: ~ nyeupe white; ~ ya kijani green; ~ya kijivu grey. 2 chemical (white; black; red etc) applied on surface to make it look different from the original: Paka ~ paint; Ubaguzi wa ~ colour bar; apartheid. (Kaj)
rarua: tear apart; rip. () rarulia; ()raruka; () raruana; () rarusha
rasmi: official; formal: Vazi ~ official dress; Barua ~ official letter
rasta: rasta. (Kng)
raufu: gentle
rauka: wake up early. () raukia; () raukika; () raukisha
rauni: walk about aimlessly; wander; loiter. () raunia; () raunika; ()raunisha
rausi: trim sail; straighten a sail. ()rausia; () rausika; () rausisha
redio: radio. (Kng) redio
rejea: return. 2 refer to. () rejelea; () rejeka; () rejeana; () rejesha; () rejewa
remba: beautify; decorate. ()rembea; () rembeka; () rembana; ()rembesha; () rembwa
renga: cheat; make a fool of. ()rengea; () rengeka; () rengana; ()rengesha; () rengwa
renge: fool; youths' dance performed in a circle
riahi: gas in the stomach
riale: rial
ridhi: agree; be pleased. () ridhia; () ridhiwa; () ridhika; () ridhiana; () ridhisha
rinda: pleat. 2 dress; gown
ringa: show off; put on airs. 2 boast. () ringia; () ringika; () ringisha; impregnate. () ringia; ()ringika; () ringana; () ringisha; ()ringwa
ripea: repair; mend. () ripelea; () ripeka; () ripesha; () ripewa. (Kng)
rithi: inherit. () rithia; ()rithiana; () rithiwa () rithika; ()rithisha
ronda: type of sardine
rondo: (mnyama) leg
rubaa: team; league
rudia: repeat; revise; return to. ()rudika; () rudiana; () rudisha; ()rudiwa
rufaa: appeal: Kata ~ lodge an appeal
rufai: ascend. () rufaia; ()rufaiwa; () fufaika; () rufaisha
rukia: fly over; jump over. 2 jump on to. 2 interrupt
rukuu: bow during prayer. ()rukuia; () rukuika; () rukuisha
rumba: rumba. (Kng)
rumbi: large water pot
runda: be stunted. () rundia; ()rundika; () rundana; () rundisha; () rundwa
rundo: pile; heap: ~ la karatasia pile of papers; ~ la takataka a pile of garbage
rungu: club; knobkerrie
rupia: rupee. (ms) ~ kwa ya piliexactly the same; very similar. (Khi)
rusha: toss up; throw. 2 deny to pay. () rushia; () rushika; () rushana; () rushwa
saada: luck
sachi: search. (Kng); search.() sachia; () sachiana; () sachiwa; ()sachika; () sachisha. (Kng)
sadfa: simultaneous sag.a happening of two events
sagai: javelin; short spear; festivities bringing together paternal sides following the acceptance of marriage gifts
sagua: ridicule; make fun of; mock; joke with.() sagulia; () sagulika; ()saguana; () sagulisha; () saguliwa
saguo: joke; ridicule
sahau: forget; overlook. () sahaulia; () sahulika; () sahauliana; ()sahaulisha; () sahauliwa
saili: interview; interrogate; question. () sailia; () sailika; () sailisha; ()sailiana; () sailiwa
saini: signature; attestation: Tia ~put your signature; sign; sign; attest.() sainia; ()sainika; () sainiana; () sainisha; ()sainiwa. (Kng)
sairi: coax; allure; entice; flatter. ()sairia; () sairika); () sariana; ()sairisha; () sairiwa; coast; hug the shore in a vessel. 2 pound sth in mortar by hitting the pestle on the sides of the mortar. () sairia; ()sairika; () sairisha; () sairiana; ()sairiwa; (Uislamu) one of the doomsday fires
saisi: groom
saizi: size. (Kng)
salia: be extra/left over
salio: remains; remnants; leftovers; balance
salua: history; ancient times. saluti* salute: Pokea ~ take the salute. (Kng)
samai: instrumental religious music
sambo: sailing vessel
samli: ghee
sanaa: art; work of art; skilled handicraft: Kazi ya ~ handcraft; craftwork; ~ za maonyesho theatre arts
sanda: shroud; burial cloth
sanii: produce an art work; make skillfully; invent. () sanilia; () sanilika; () sansha; () saniwa
satua: capability; ability
saumu: fast; fasting; garlic
sauti: sound; voice: Kwa ~ moja in unison; in total agreement; Kuwa na ~ have voice; be responsible for; have authority
sekta: sector. (Kng)
sekua: uproot; shove. () sekulia; () sekulika; () sekuana; () sekulisha; () sekusekunde kuliwa
sembe: corn flour; maize flour. sembuse let alone; not to mention
senea: become blunt. () seneka; () seneza
senga: incise; cut. () sengea; ()sengeka; () sengana; () sengesha; ()sengwa. seng'
sensa: census. (Kng)
senti: cent; one cent piece; coin. (Kng)
setla: settler. (Kng) seuze pia sembuse let alone; much less; to say nothing of
shaba: brass; copper
shaja: wander aimlessly; roam about; stray. () shajia; () shajika; () shajisha
shaka: doubt; worry; uncertainty:Tia ~ give rise to doubt; Bila ya ~ undoubtedly; Usiwe na ~ don't worry; chase away; drive off. ()shakia; () shakika; () shakana; ()shakisha; () shakwa
shamu: Syria: Bahari ya ~ Red Sea
shani: novelty; curiosity; adventure; fluke
shari: anger; adversity. 2 trouble; malice; evil: Taka ~ look for trouble
shata: lees; oil- cake. shatashata juicy; thick; rich food: Ndizi zimetiwa tui ~ the bananas are rich in coconut milk
shati: shirt. (Kng)
shaua: praise/glorify sb; exalt; flatter. 2 show off; be proud/arrogant; be conceited. ()shaulia; () shaulika; () shauana; ()shaulisha; () shauliwa. shaufu* showy; prententious; given to frivolity
shavu: cheek: ~ la samaki gill
sheha: headman; chief; councillor. 2 old person; village head; party head. 3 (Zanzibar) ward executive officer
shehe: sheikh; wise old man
shela: veil; sword dance
shere: ridicule; derision; joke:Chezea ~ play a joke on; make a fool of
shiba: be satisfied; be satiated. 2 be in very close contact with sb; have a soft spot for sb. () shibia; () shibiwa; () shibika; () shibana; () shibisha
shibe: satiety; fulness; satisfaction.Nilikula ~ yangu I ate to my satisfaction
shida: hardship; distress; problem; difficulty; want: Hakuna ~ there is no problem; Kuna ~ ya maji there is scarcity of water
shika: hold; catch; apprehend; arrest: ~ kalamu hii hold this pen; Polisi walim~ mwizithe police arrested a thief. 2 stick; adhere; cling. (nh) () ~ adabu be polite; (2) ~ maneno be cautious. (3) ~ njia (a) go. (b) follow the way/footsteps of sb; (4) ~ sikio give sound warning/ advice. () shikia; () shikika; () shikana; () shikisha; () shikwa
shime: call or appeal to increase effort
shimo: hole; pit; cavity: Sahani ya ~ hollow plate
shina: stem; tree trunk; (siasa) cell: Kiongozi wa ~ wa CCM CCM cell leader
shira: syrup
shiti: bed sheet. (Kng)
shizi: alcohol made from coconut palm; bamboo or cashew apple
shoga: woman's female friend. 2 homosexual; gay
shogi: pit inside a vessel where slaves were hidden
shoka: axe: ~ la bapa adze
shona: sew; mend by sewing: ~ upindohem. () shonea; () shoneka; ()shonana; () shonesha; () shonwa
shore: black-capped bulbul: ~kishungi paradise fly-catcher; ~ wanda grey headed sparrow; tuft. shoro unsuccessfully; awkwardly; crookedly. shoti1* hurriedly; fast; quickly: Farasi aliondoka ~ the horse galloped. (nh) Enda/Toka ~ gallop
shoti: loss: ingia ~ make a loss. (Kng)
shoto: left handedness; left hand. shoto2 astray; askew: Mambo yanakwenda ~things are going astray
shtua: startle; scare; shock; surprise. 2 sprain; dislocate: Alipoanguka ali~ goti lake he sprained his knee when he fell down. ()shtulia; () shtuliwa; () shtuka; ()shtusha; () shtuana; startle. 2 sprain. ()stulia; _ () stuliwa; () stuka; ()stuana; () stusha
shufu: see; look at. () shufia; ()shufika; () shufisha; () shufana; ()shufwa
shuka: debark; disembark; alight; descend; go down: ~ pwani land on the beach; go down to the beach; ~ kwenye gari alight from the car. 2 fall: Bei ya mchele ime~ the price of rice has fallen. () shukia; () shukika; ()shukisha; bed sheet; loin cloth. shuke pia
shuku: suspect; doubt; feel scruples. () shukia; () shukika; () shukiana; () shukiwa; () shukisha
shule: school: ~ ya msingi primary school; ~ ya chekechea kindergarten/nursery school; ~ ya bweni boarding school. (Kje)
shuli: backyard
shume: paka ~ wild cat; large male cat.2 evil person
shupu: straw basket
shura: saltpetre. (Kaj)
shuru: embroidery stitch; tack (clothes): () shuruti shuria; () shuriwa; () shurika; ()shurisha. shuruti* by force; obligatory; compulsorily
shuta: fart; break wind. () shutia; () shutika; () shutisha
shuti: (mpira) kick; shot. (Kng)
shuzi: fart. shwari* calm; tranquil
siafu: red brown ants; safari ants
siagi: butter
siahi: scream
siasa: politics: Elimu ya ~ political education
sifia: praise sb; glorify; honour sb. ()sifiana; () sifiwa
sikia: hear: Unam~ ? do you hear him? 2 obey; pay attention: Hasikii aambiwalohe pays no attention to what he is told. 3 feel; sense: ~ baridi feel cold; ji~ vibaya feel unwell; ji~ nyumbani feel at home; ~ njaa feel hungry. () sikika; () sikiana; () sikiza; ()sikiwa
sikio: ear
silia: entrust sth to sb while away. ()sililia; () silika; () simbik.a siliana; () silisha; () siliwa
simba: lion: Mtoto wa ~ lion cub; (unajimu) Leo; code a language. () simbia; () simbika; () simbisha; () simbwa
simbi: small cowry shell (used for playing certain games and formerly used as currency)
simbo: thimble. (Kng)
singa: massage; rub with oil/perfume. () singia; () singana; () singika; ()singisha; () singwa; long straight hair
singe: bayonet
sinia: platter
sinki: sink. (Kng)
sinua: push aside; bend over; tilt. ()sinulia; (tdes) sinulisha; () sinuliwa; ()sinuka; () sinuana
sinya: hate; despise; scorn. () sinyia; () sinyika; () sinyana; () sinyisha; () sinywa
sista: nun; sister. sofa 2 senior hospital nurse. (Kng)
skeli: scale. (Kng)
sketi: skirt. (Kng)
skuli: school. (Kng)
skuta: scooter. (Kng)
sleti: slate. (Kng)
sodai: arrogant person; proud person
sogea: move: ~ mbele move forward; ~ karibu move nearer; ~ mbali zaidi move further away. () sogelea; tdek) sogeleka; ()sogeleana; () sogelewa; () sogeza
sogoa: (si rasmi) have a chat. ()sogolea; (tdes) sogolesha
sokoa: untwine sth from inside; unwind from sth. () sokolea; (tdek) sokoleka; (tdes)sokolesha; () sokolewa
soksi: sock. (Kng) somesh.a
sokwe: ape
somba: carry to and fro; collect: Siku nzima ana~ maji she's been carrying water the whole day. () sombea; () sombeka; () sombesha; () sombwa; fish
somea: read to/for. 2 study; take a subject: Ana~ nini? what subject is he studying?Ana~ udaktari he is studying doctor of medicine. () someka; () somesha
songa: press. (nh) ~ mbele go forward; ~ ugali prepare stiff porridge. 2 fit tight. () songea; () songeka; () songana; () songesha; () songwa; squeeze; twist. () songea; () songeka; () songana; () songesha; () songwa
sonoa: hurt; grieve; pain. () sonolea; () sonolewa; () sonoka; () sonoana; () sonosha
spaki: spark. (Kng)
spana: spanner. (Kng)
spidi: speed. (Kng)
spika: speaker. (Kng)
spoti: sport. (Kng); sport. (Kng)
stadi: skillful person; expert
staha: respect; honour; reverence. (Kaj)
stahi: respect; honour. () stahia; () stahika; () stahiana; () stahisha; () stahiwa
staka: leather sandal
stala: sash (worn by priests)
stata: starter. (Kng)
stawi: prosper; thrive. () stawia; () staawika; ( ) sta-wisha
steki: steak. (Kng)
stima: steamer. (Kng); gas cooker. (Kng)
stimu: spark; electricity
stova: gas cooker
stovu: stove. (Kng) stu.a pia
stuli: stool. (Kng)
suala: issue; question
suezi: soft steel
sufii: hermit; dervish; mystic; monk
sugua: scrub; rub; scour; clean by rubbing. () sugulia; (tdek) sukut.u sugulika; (tdes) sugulisha; () suguliwa; () suguana
sukua: break apart. () sukulia; ()sukuka; () sukuana; () sukusha; ()sukuwa
sumba: worry. 2 be confused. ()sumbia; () sumbika; () sumbisha; ()sumbwa; sell at a give away price; sell sth off. () sumbia; () sumbika; () sumbisha; ()sumbwa; enclosed tip of a banana plant. 2 coconut shell fibres
sunza: give sth relu-ctantly. ()sunzia; () sunzika; () sunzana; ()sunzisha; () sunzwa; feel around; grope about. ()sunzia; () su-nzika; () sunzisha; throw with a sling. 2 move the hand forward and backward. () sunzia; ()sunzika; () sunzana; () sunzisha; ()sunzwa; tease; provoke; annoy; irk. ()sunzia; () sunzika; () sunzana; ()sunzisha; () sunzwa
sunzu: tuft of hair on the fore head
suria: concubine
surua: measles. (Kaj)
surwa: additional broth
susia: boycott. () susilia; ()susika; () susiana; () susisha; ()susiwa
suuza: rinse; swill. () suuzia; ()suuzika; () suuzana; () suuzisha; ()suuzwa
swaga: drive (animals) along fast. ()swagia; () swagika; () swagisha; ()swagwa
swala: prayer; gazelle
swali: question; pray. () swalia; ()swaliwa; () swalika; () swalisha
sweta: sweater. (Kng)
swila: hammock. 2 spitting cobra. T
taala: exalted: Allah ~ God is exalted
taali: come. () taalia; () taalika; () taalisha
tabia: habit; character
tabii: imitate. () tabilia; () tabika; () tabiana; () tabisha; () tabiwa
tabua: beat a sisal leaf till the fibres can be seen. () tabulia; () tabuka; ()tabusha
tagaa: straddle. () tagalia; ()tagalika; () tagalisha; branch
taifa: nation
taipu: type. () taipia; ()taipiana; () taipiwa; () taipika; ()taipisha. (Kng) taipu2* pia
tairi: tyre. (Kng)
taiti: skin-tight clothes. (Kng)
takia: cushion
takua: piety; devoutness
talii: peruse. () taliia; () taliika; () taliisha; () taliiwa; tour. () talia; () talika; () talisha; () taliwa
tamaa: lust; longing. 2 tamakan.i expectation; ambition
tamba: walk in a conceited way; strut proudly. () tambia; () tambika; ()tambisha; narrate. () tambia; ()tambika; () tambiana; () tambisha; () tambiwa
tambi: vermicelli; noodles; pasta
tambo: puzzle; cryptic saying; size; amplitude
tamia: be charming; be pleasing; be attractive; be tamka delightful. () tamilia; () tamika; ()tamisha
tamka: pronounce; state. () tamkia; () tamkika; () tamkisha; () tamkwa
tamko: pro-nuncement; statement; procla-mation
tamwa: enjoy; profit from; feel happy. () tamwia; () tamwika; () tamwisha
tanda: extend; spread; lay tanga out. 2 overcast; spread over. 3 catch fish by spreading net or large calico in water. ()tandia; () tandika; () tandisha/tandaza; () tandwa
tando: fish trap
tandu: centipede
tanga: sail: Tweka ~ hoist sail; tua ~lower sail. tanga; formal mourning period; loiter; wander; stroll about. ()tangia; () tangika; () tangisha
tange: cleared forest for farming
tangi: tank; cistern. (Kng)
tango: cucumber; loitering; wanderings. tangu since: ~ lini? since when?
tania: joke; chaff. () tanika; ()taniana; () tanisha; () taniwa
tanji: act of impounding sb's property (in order to recover an unpaid loan): Piga ~impound
tanua: widen; expand. 2 stretch apart; open wide. () tanulia; () tanuka; ()tanuana; () tanusha; () tanuliwa
tanza: complicate. () tanzia; ()tanzika; () tanzana; () tanzisha; ()tanzwa
tanzi: noose; loop
tanzu: branch. subsildiary: JV Group ina makampuni ~ mengi The JV Group has many subsidiary companies
tapia: strive for; pursue; be avid for. () tapilia; () tapika; () tapisa; ()tapiwa
tasua: solve. 2 clarify; elaborate. ()tasulia; () tasuka; () tasusha; ()tasuliwa
tatua: solve. 2 disentangle. ()tatulia; () tatulika; () tatuliwa
taulo: towel. (Kng)
taumu: prop; support
tauni: bubonic plague
tausi: peacock; peahen
tegea: lay trap for. 2 shirk work. ()tegeka; () tegeana; () tegesha; ()tegewa
tegua: disassemble a trap. 2 remove (a pot) from a stove/ cooker. 3 sprain; dislocate. () tegulia; () teguka; () teguana; () tegusha; () teguliwa
teksi: taxi. (Kng)
tekua: push down. 2 uproot forcefully. () tekulia; () tekuka; () tekuana; () tekulisha; () tekuliwa. tele plenty; full. fully
telki: horse's quick trot: Enda ~ run; trot. (Khi)
tembe: pullet; young hen; flat-roofed house; pill; tablet: ~ya aspirini asprin tablet
tembo: elephant: Mkono tembo wa ~ a type of big and long plantain; coconut palm wine; changu-like fish
temea: spit at/on. () temelea; ()temeka; () temeana; () temesha; ()temwa
temsi: filigree
temua: hollow out a log. () temulia; () temuliwa; () temuka; ()temuana; () temusha. tena; again
tenda: do; act; treat: ~ vizuri perform well. 2 treat sb badly. () tendea; ()tendeka; () tendesha; tender; bid. (Kng)
tende: elephantiasis; date
tenga: separate; isolate; ostracize. ()tengea; () tengeka; () tengesha; ()tengana; () tengwa; bamboo basket; type of ray fish; animal/bird trap. terebesha
tenge: disorder; chaos. crooked; out of line: Mambo yamekwenda ~ things have gone to the dogs; trapezium
tepua: enervate; make weary. ()tepulia; () tepuka; () tepusha
tetea: cackle; speak up for; defend. ()tetelea; () teteka; () teteana; ()tetewa
teuka: belch; burp. () teukia; ()teukika; () teu-sha. teule chosen; elect
thama: except for; likewise
thori: impotent
tiabu: stick throwing game
tiara: kite; crown
tibua: stir up; unsettle. (ms) ~ mambointrude other peoples' affairs. () tibulia; () tibuliana; () tibuka; () tibuana; () tibulisha; () tibuliwa
tifua: loosen soil; make soil soft. ()tifulia; () tifuka; () tifusha; ()tifuliwa
timba: step on sth e.g. mud or dung. 2 use sth extra-vagantly. () timbia; ()timbika; () timbana; () timbisha; ()timbwa; string of sth e.g. beads. tindi; malt
timbe: lump of cast or unwrought metal
timbi: bracelet; armlet; bangle
timia: be completed; be realized; 2 come to term; be concluded. () timilia; ()timilika; () timiza; (tdsw) timizwa
timka: run off; trot away; dash. 2 be ruffled. () timkia; () timkika; ()timkana; () timkisha; () timkwa. timtimu ruffled: Amekuja hapa nywele ~ he came here with ruffled hair
timua: run away; dash; speed off. 2 disarrange; make ruffle: ~ nywele ruffle the hair. () timulia; () timulika; () timulisha; () timuana; () timuliwa
tinda: shape eyebrows or hairline: ()tindia; () ti-ndika; () tindisha; () ti-ndana; () tindwa
tindi: joint. tindi; spoke
tindo: cold chisel; punch
tinga: swing. () tingia; ()tingika; () tingisha; encircle; hem in; entwine. ()tingia; () tingika; () tingisha; get to the net/goal: Mpira ume~ golini the ball got into the goal
tinge: competition in leaping
tingi: strope used in changing sail
tinya: cut a small piece e.g. of meat. () tinyia; () tinyika; () tinyisha; ()tinyana; () tinywa
tisha: frighten; terrify; threaten. ()tishia; () tishika; () tishana; ()tishwa
tisti: firm; unwavering: Simama ~ stand firm
titia: sink. () titilia; () titika; ()titisha
toboa: drill; bore; puncture. 2 speak out; reveal. () tobolea; () toboleka; () toboana; () tobolesha; () tobolewa
tobwe: hole
tochi: torch; flashlight. (Kng)
tofya: press gently. () tokeo tofyea; () tofyeka; () to-fyana; ()tofyesha; () to-fywa
togwa: sweet malt drink
tohoa: dilute. 2 adapt/ modify. ()toholea; () toho-leka; () tohoana; ()toho-lesha; () toholewa
tokea: appear; occur; happen; emerge. () tokeka; () tokeza
tokeo: result; tokez.a outcome
tokwa: shed; gush out: ~ na machozished tears; weep
toleo: issue. 2 offering. 3 edition
tomba: fuck; have sex; copulate. ()tombea; () tombeka; () tombana; ()tombesha; () tombwa
tombo: human tongo breast; quail
tomea: apply final touches of mason's work; do retouching. 2 write dictionary entries. 3 press grains in a sack to fill to the top. ()tomelea; () tomeka; () tomesha; ()tomewa
tondo: kind of snail
tonea: plait hair for the first time. ()tonelea; () toneleka; () toneana; ()tonesha; () tonewa
tonga: kind of fruit resembling a coconut; type of medlar
tonge: lump/ball of food
tongo: discharge from eye(s). tongo; flock of small birds; deserted place
topea: sink; be immersed. 2 be expert; specialize. () to-peka; () topeza
topoa: remove from; pull out; rescue from; remove a magic spell.() topolea; ()topoleka; () topoana; () topolesha; () topolewa; mark boundaries. () topolea; () topoleka; () topoana; () topolesha; () topolewa
tosha: be enough; be sufficient: Chakula hiki hakija~ this food is not enough; Nguo hii inam~ this cloth fits her: () toshea; ()tosheka; () toshana; () tosheza; ()toshwa
totoa: hatch out. () totoro () totoleka; () totolesha; () totolewa. totoro completely: Giza ~ complete darkness
towea: use as a relish. () towelea; (tdek) toweleka; (tdes) toweleza; ()towelewa
trela: trailer. (Kng)
treni: train. (Kng)
tuama: be nice; calm; precipitate. ()tuamia; () tu-amika; () tuamisha; ()tuamwa
tubia: repent. () tubika; ()tubisha
tuguu: grain-drying mat
tuili: take long time to complete a task. () tuilia; () tuilika; () tuilisha
tukia: happen; occur. () tukilia; ()tukika; () tukiza; () tukiwa
tukio: event; happening; occurrence
tukwa: tonsil. tule* unpleasant: Tabia ~ unpleasant behaviour. 2 weak; poor
tulia: be calm; be settled; be quiet:Upepo ume~ the wind is calm. () tulika; () tuliza. tulivu quiet; peaceful: Mtoto m~ tumbo a quiet child
tumba: pod; bud; moon's halo; type of small long drum; bale; large bundle
tumbi: basket used for carrying fish. tumbi2 a lot; many: Ameniletea maembe ~ nzima he brought me a lot of mangoes
tumbo: appendix; stomach. 2 belly; abdomen. 3 womb: Wamezaliwa ~ moja they are born from the same mother; ~la kuharadiarrhoea. tumbo; literary work e.g. poetry; songs etc
tumbu: iron door lock
tumia: use; utilize; apply: () tumika; () tumiana; () tumisha; () tumiwa
tunda: pick/pluck fruits. () tundia; () tundika; () tundisha; () tundiwa; fruit
tundu: hole; hollow; nest; den
tunga: string. () tungia; ()tungika; () tungana; () tungisha; () tungwa; form matter; suppurate: ~ mimba get pregnant; ~ usaha suppurate. ()tungia; () tungika; () tungana; ()tungisha; () tungwa; compose: ~ hadithi compose a story; ~ hotuba write a speech; ~ shairicompose a poem. () tungia; () tungika; () tungana; () tungisha; () tungwa
tungi: lamp
tungo: composition e.g. of poems; songs etc
tunza: care for; take care of look after; maintain; preserve; conserve; provide for. ()tunzia; () tunzika; () tunzana; ()tunzisha; () tunzwa; award; reward. () tunzia; () tunzika; () tunzana; () tunzisha; () tunzwa
tunzo: reward; award
tutia: fill up a pit or hole with rubbish; level a road. () tutika; () tutiana; ()tutisha; () tutiwa
tutuo: avidity; burning desire; a passion for twek.a something
tuzua: ashame; disgrace. () tuzuia; () tuzuka; () tuzuana; () tuzusha; () tuzuwa
twaza: vaunt; be proud/arrogant. ()twazia; () twazika; () twazana; ()twazisha; () twazwa
tweka: hoist e.g. a flag; a sail of a boat; a load on the shoulder. () twekea; ()twekeka; () twekana; () twekesha; () twekwa; load
tweta: gasp; pant for breath. ()twetea; () tweteka; () twetana; ()twetesha; () twetwa
tweza: humiliate; belittle; degrade. ()twezea; () twe-zeka; () twezana; ()twezesha; () twezwa
twiga: giraffe
twika: lift a load; put on a head-load. () twikia; () twikika; () twikana; ()twikisha; () twikwa
tyubu: tube. (Kng) U
uadui: enmity
uaili: blame; guilt
uanga: witchery; wizardry
uashi: masonry
ubale: (mbale) slice. 2 middle bunch of dwarf palm
ubani: incense; frankincense. 2 customary fee. 3 money for condolence. (nh) ()Tia ~ pray for the dead person. (2) Wangu wa ~my lover
ubano: (mbano) clip
ubapa: (bapa) flat blade (of a knife etc.); flat surface
ubati: (mbati) small long room in a house; (mbati) small whip
ubavu: (mbavu) rib; flank. 2 the side: Lala ~ lie on the side; Mashua imelala ~the boat lies on its side
ubawa: wing. 2 anything with similar shape; (mbawa) wing: ~ wa eropleniaeroplane wing
ubaya: evil; badness
ubele: feather
uberu: (mberu) small cloth in a dhow or boat
ubeti: (beti) stanza; verse
ubini: being son of
ubivu: ripeness
uboho: bone marrow. 2 brain
ubora: quality; excellence. 2 uchakavu feeling of superiority
ubovu: rottenness; unfortunate aspect of sth; fault; defect
ubozi: ignorance; inexperience; foolishness; stupi-dity
ububu: dumbness; small black beads
ubuge: frequent nibbling
ubugu: (mbugu) kind of ropelike plant
ubutu: bluntness
ubuyu: baobab nut/pith
ucheu: ploughed land sowing
udaha: cayenne pepper
udaku: blabbering
udevu: (ndevu) beard
udhia: annoyance; disturbance; vexation
udobi: laundering. (Khi)
udodi: (dodi) wire bracelet
udogo: smallness; minuteness. 2 scarcity
udole: energy; power to do sth. (ms)Hana ~ he is weak
udugu: kinship; relationship
uduvi: shrimp
ufifi: awareness; hint
ufite: long narrow cloth
ufito: (fito) lath/pole for building
ufizi: (fizi) gum
ufuko: (fuko) shoreline; beach; coast
ufupi: shallowness; brevity; shortness:kwa ~ in brief
ufuta: sesame seed/oil; simsim
ugaga: tartar
ugale: (gale) core; pith
ugali: stiff porridge
ugavi: distribution; supply: ~ wa umemeelectrical supply: ~ na utashi supply and demand
ugavu: (ngavu) fish/animal net; tartar
ugege: grating; dry feeling on teeth caused by acid fruits; acid taste
ugemi: taz. ugemaji
ugeni: strangeness; newness; foreignness. 2 visitor(s); official visitor(s). 3 visitation. ugenini in a foreign place
ugogo: provocation. uhafifu
ugoni: act of surprising one committing adultery. 2 fine for committing adultery
ugoro: snuff. 2 nonsense
ugoya: (ngoya) feather; quill
ugozi: small piece of hide/skin
ugumu: hardness; difficulty. 3 miserliness
uguza: nurse the sick. () uguzia; ()uguzika; () uguzana; () uguzwa
uhaba: shortage; scarcity
uhaji: (nh) Ingia ~ (a) convert to the Moslem faith. (b) be circumcised as a condition of converting to Islam
uharo: soft faeces; running stool; purgation
uheke: gossip; hypocrisy
uhuni: vagrancy; hooliganism. 2 bachelorhood
uhuru: independence; freedom; liberty
ujaji: coming; approxi-mation; judgeship.(Kng)
ujaka: kind of spinach; odour; bad smell; stink
ujana: youth; adolescence
ujane: widowhood; widower-hood
ujari: (njari) tiller-rope; rudder tackle
ujazo: volume; capacity
ujima: communalism; subsistence economy; communal work: Lima ~ cultivate commu-nally
ujira: wage; pay
ujiti: (njiti) twig
ujoli: free slave lineage/ descent
ujuba: fearlessness and insolence
ujumi: aesthetics
ujusi: post-natal defile-ment. 2 post-natal odour
ujuvi: impudence; impertinence; sauciness; precocity; indiscretion; curiosity
ujuzi: skill; know-how; experience; expertise
ukafu: foam; froth; dryness of teeth after eating unripe acid fruits; acid taste
ukale: distant past
ukali: fury; severity. 2 keenness; intensity
ukame: drought; dry spell
ukano: sinew; tendon
ukasi: (kasi) coconut-shell ladle
ukata: poverty
ukavu: dryness; imperturbability: ~ wa machounconcerned/fearless; unabashed look or character
ukaya: (kaya) veil
ukemi: scream; shout; cry; call. 2 reproof; scolding
uketo: depth; popcorn
ukigo: (kigo) fence; hedge
ukili: (kili) strip of plaited palm leaf
ukiwa: solitude; loneliness
ukoga: tartar (on the teeth). 2 scum (on water)
ukogo: (kogo) waist beads
ukoja: (koja) bead necklace
ukoka: creeping grass. (ms) Vika kilemba cha ~ flatter sb
ukoko: bottom food crust. 2 scurf
ukoma: leprosy
ukomo: end; limit: ~ wa njia end of the road
ukope: (kope) eyelid. 2 eye lash. (ms) Anadaiwa kope si zake he has many debts
ukopi: borrowing
ukora: vagrancy
ukosi: (kosi) collar
ukozi: fixed forestay in a vessel
ukuba: bad omen; misfortune; evil fortune: Usinitie ~ don't bring me ill luck; bad smell; odour; stink
ukufi: (kufi) handful
ukuni: (kuni) firewood; fuelwood
ukupe: exploitation
ukura: wicker trap's cover; kind of millet
ukuta: (kuta) wall
ukuti: (kuti) coconut leaf. 2 children's circling game
ulafi: gluttony
ulaji: eating: ~ rushwa corruption; bribery
ulaka: cashew apple wine
ulalo: diagonal; camping place
ulama: expert; specialist. 2 scholar
uledi: cabin boy
ulevi: intoxicant. 2 drunkenness; alcoholism
ulezi: upbringing; finger/bullrush millet
ulifi: payment; paying
ulili: stretcher. 2 kind of a ulimaji platform. ulimaji cultivating
ulimi: (ndimi) tongue. 2 tongue-like object. 3 tongue of flame
uliza: ask; question; interrogate inquire. () ulizia; () ulizika; () ulizana; ()ulizisha; () ulizwa
ulizo: question. 2 question mark
ulodi: pomposity; swagger. (Kng)
ulozi: witchcraft
umale: sea depth
umati: crowd; throng
umbia: soar about; glide round. ()umbilia; (tdek) umbilika; () umbisha
umbua: depreciate; devulge; degrade; shame sb; ruin someone's reputation. 2 disfigure; deform; deface. ()umbulia; (tdes) umbulisha; () umbuliwa; () umbuka; () umbuana
umeme: accumulator; lightning. 2 electricity
umero: gluttony; greediness
umika: cup blood. () umikia; ()umikika; () umikana; () umikisha; ()umikwa
umito: oedema. 2 heaviness/idleness of a man whose wife is pregnant (thought to be caused by his wife's condition)
umoja: unity; fellowship. 2 singularity; (sarufi) singular. Umoja wa
umuka: be leavened/raised. ()umukia; () umukika
unane: bicycle spoke; slenderness and weakness of a person
unene: (mtu) obesity; thickness
uneni: speaking badly to sb; backbiting
ungua: burn. () ungulia; (tdek)ungulika
unika: grumble; complain. ()nung'unikia; () nung'unikika; () nung'unikana; () nung'unikisha. nung'
uniko: complaint(s); discontentment; disappointment; complaint; grumbling; complaint
unono: comfort; luxury. (ms) lala ~ may you sleep comfortably
ununu: inner coconut leaf fibre: Puna ~strip the fibre
unyaa: nausea; disgust
unyeo: (nyeo) skin pore
uongo: lie; falsity; falsehood
upaji: talent; endowment; offering; giving
upana: width; breadth
upapi: (papi) strip; gusset
upara: baldness
upasi: enmity
upati: (pati) wearing a loin cloth by tucking it up between the legs. 2 sanitary napkin
upatu: (patu) gong. 2 plate for collecting gifts at a celebration. 3 gifts collected and upenyezi presented at a celebration. 4 arrangement of contributing money to group members in turns. (Khi)
upawa: (pawa) shallow ladle
upele: scabies
upenu: (penu) eaves; overhang of roof. 2 appendage to house
upepe: (pepe) bean's coating
upepo: weather vane. kipima; (pepo) wind; breeze
upera: type of fine fibre producing plant. upesi quickly; hurriedly
upeto: (peto) bend
upevu: maturity
upofu: blindness. upogo awry; zigzag: Mambo yamekwenda ~things have gone awry
upole: gentleness; humbleness; urafiki humility
uporo: leftovers
upote: (pote) thong; bowstring
upuga: (puga) young fruitage
upupu: cow-itch plant. 2 stinging rash from grain dust
uradi: (nyiradi) recitation after main prayer: Vuta ~ kwa tasbihi recite by using prayer beads
uraia: citizenship. 2 civics
urais: presidency
urari: balance: ~ wa hesabu balance of accounts
ureda: happiness; comfort; luxury
urefu: distance; length: ~ wa barabarathe road's length. 2 height
uroho: greediness; gluttony
urumo: poverty; indigence; need; straitened circumstances: Pigwa na ~ be indigent; be in need; be financially strained; be poor
urusi: (rusi) one-month-old calf
usafi: cleanliness; hygiene; sanitation: ~ni tabia hygiene is an in-born habit. (Kaj)
usaha: pus
usani: metal work; smithery
usasi: hunting
usawa: equality: ~ wa binadamuequality of human beings; level: ~ wa bahari sea-level
useja: bachelorhood; celibacy; (seja) collar of beads
usemi: (semi) style of speaking. 2 expression; statement; saying. 3 language; dialect
usena: bee sting; friendship; comrade-ship; confidence
ushei: and a bit; plus a bit: Amenipa shilingi mia na ~ she has given me one hundred plus shillings
ushwa: husk; bran
usiku: night
usira: powder made from an animal's burnt skin; used as a protective charm against that particular animal
usiri: delay; lagging
usisi: type of black bird
usita: alley; narrow passage; path
usito: deafness
usitu: (situ) split wild date usuluhishi palm leaf
usono: resting
usubi: gnat; midge; sandfly
usufi: (sufi) kapok
usufu: (sufu) wool
usugu: callousness
ususi: plaiting
ususu: corridor
utaba: fearing breaking/ plucking off
utadi: rudeness
utago: broom grass
utaji: head gear/scarf
utako: keel. utaleleshi* prostitution
utamu: sweetness; deli-ciousness
utani: joking relationship. 2 joke; friendly teasing
utari: (tari) ship hauling cable. 2 string; cord; rope
utasa: sterility; barrenness
utasi: inability to speak; speech impediment; being tongue-tied
utata: (tata) complexity; complication; (tata) lisp; speech impediment
utatu: trinity: ~ Mtakatifu The Holy Trinity
utawa: monasticism. 2 seclusion. utanzu
utaya: (taya) jaw; jaw-bone
utego: telescopic sight
utepe: (tepe) ribbon; band. 2 tape
utesi: rumour
utete: reed
utiko: roof ridge
utoko: (toko) vaginal mucus
utoro: absenteeism; truancy
utosi: head; crown. utupu
utoto: childhood
utovu: lack : ~ wa nidhamu lack of discipline; indiscipline
utume: state of being authorized to do sth; service; apostolate; pro-phecy
utupa: type of fish-killing poisonous plant
utupu: nakedness; nudity. 2 uturi emptiness
uturi: u-] perfume; attar
utuvu: serenity; equanimity; calmness
uuaji: murder
uungu: divinity
uunzi: formation
uvati: gunwale or rubbing strake surrounding top of hull
uvivu: laziness
uvuli: manhood; shade
uvumi: rumour; rumbling sound. uwanja
uvuvi: fishing
uwasa: (nyasa) stick/lathe/rod for strengthening walls of native houses
uwati: (mbati) rubbing strake; wash strake; (mbati) skin eruption; rash
uwatu: fenugreek; kind of herb whose fruits are used for flavouring curries
uwayo: (nyayo) sole; footstep; footprint
uwazi: emptiness; openness; open space; vacuum
uwele: (mawele) bullrush millet
uweza: ability; power: ~ wa Mungu the power/omnipotence of God
uwezo: ability; capability; power. 2 authority
uyoga: mushroom. u.za ktele] sell. () uzia; () uzika; ()uzana; () uzisha; () uzwa
uzani: weight
uzawa: offspring; progeny. 2 indigenousness; indigenization
uzazi: prosperity; abundance; birth; childbearing: ~ wa majirabirth control. 2 offspring; progeny
uzima: adulthood; matu-rity; health; wellbeing; life
uzito: weight. 2 serious-ness; importance. 3 difficulty
uziwi: deafness
uzuio: hindrance; prevention; obstruction
uzuka: period a widow lives in seclusion after her husband's death
uzulu: dismiss; fire; retire; resign. ()uzulia; () uzuliwa
uzuri: beauty. 2 () uzulika; () uzulisha
uzuzi: searching for sth hidden
uzuzu: inexperience. 2 foolishness; imbecility; stupidity. V
vaana: embrace in a fight. () vaania; () vaanika; () vaanisha
valia: dress up. () valika; ()valisha
valid: right: Ni ~ yako it is your right
vamia: rush: Hili jambo ameli~ tu hana ujuzi nalo he/she has rushed into this matter; but he/she does not have the exprencience on it. 2 attack; ambush; raid. () vamilia; ()vamika; () vamisha; () vamiana; ()vamiwa
vanga: be restless; move about; be troubled. () vangia; () vangika; ()vangisha; () vangwa
video: video. (Kng)
vilia: stanch; stop flowing; stagnate. ()vililia; () vilika; () vilisha
vimba: expand; swell: Uso wangu ume~ my face is swollen. 2 frown; bristle up. 3 become too fat; be bloated. () vimbia; ()vimbika; () vimbana; () vimbisha; ()vimbwa; roof; thatch. () vimbia; ()vimbika; () vimbisha; () vimbwa
vinya: dandle. 2 tremble; twitch; waggle: Ali-kuwa amekasirika sana; mdomo ukawa unam~ he was so angry that his mouth twitched. () vinyia; () vinyika; ()vinyisha; () vinywa
visha: assist to wear; dress sb. ()vishia; () vishika; () vishana; () vishwa. visivyo erroneously; not in the right way: Umenielewa ~ you have misunderstood me; Ume-kwenda ~ you have taken the wrong route/direction
vizia: waylay; ambush. () vizika; () viziana; () vizisha; () viziwa. vizuri good; well; okay: Mambo yote yamekwenda ~ everything went well
vocha: voucher. (Kng)
vuata: put between the teeth and the lower lip. 2 blot. (nh) ~ ulimi keep quiet. ()vuatia; () vuatika; () vuatisha; ()vuatwa
vuaza: cut; slash. 2 hurt: Maneno yako yameni ~ I am hurt by your statement. ()vuazia; () vuazika; () vuazana; ()vuazisha; () vuazwa
vugua: cross; peer out; break through the forest/clouds. () vugulia; (tdek) vugulika; (tdes) vugulisha. vuguvugu1 warm; tepid; lukewarm; mild:Maji ~ warm water; lukewarm water
vulio: used clothes. 2 slough; snake's cast skin
vumba: fish smell
vumbi: hoover
vumbo: flour lump
vunda: go bad; become stale; rot; ferment. () vundia; () vundika; ()vundisha
vundo: bad smell; stink; stench
vunga: thick crop of hair:Mtoto huyu anapenda sana kuweka ~ this child likes to keep a thick crop of hair; deceive; lie; cheat. () vungia; () vungika; () vungana; () vungisha; () vungwa; tie. () vungia; vunganyiz.a () vungika; () vungisha; () vungwa
vunja: break; damage. 2 annul. (nh)~baraza adjourn a meeting; ~ mkataba annul a contract; ~ mwiko break a taboo; ~ rekodibreak a record; ~ ndoa annul a marriage; ~ pesachange (money); ~ mgongo tire; ~moyo disco-urage; dishearten; ~ ungo reach menarche; have the first mensruation. () vunjia; ()vunjika; () vunjisha; () vunjana; ()vunjwa
vunju: sediment: Maji yana ~ the water is muddy
vusha: assist to cross; ferry. 2 transport illegally. () vushia; () vushika; () vushana; () vushwa
vutia: be attractive/ appealing. ()vutilia; () vutika; () vutisha
vuvia: blow with a mouth or bellows: ~ moto blow the fire; ~ kiriba blow the bellows. () vuvilia; (tdek) vuvilika; (tdes) vuvilisha() vuviliwa; () vuviana
vyero: fish trap
vyoga: step on; tread upon; crush. ()vyogea; () vyogeka; () vyogana; ()vyogesha; () vyogwa. vyovyote anyhow; by whatever means. W
waama: in fact; actually: ~ jambo hili limenikasirisha sana actually I am furious about this issue
wadia: be time for; arrive: Msimu wa kupanda ume~ the sowing season is here. ()wadilia; () wadika; () wadisha
wafua: bite off. () ng'wafulia; () ng'wafuliwa; () ng'wafuka; ()ng'wafuana; () ng'wafusha
wahyi: revelation
wakaa: nyakaa time; single time; period of time: ~ tatu za chakula the three meals
wakfu: consecration: Weka ~consecrate
wakia: ounce
walia: enthrone. () walilia; ()walika; () wali-sha; invite to work; invite to celebrate.() walilia; () walika; () walisha
walii: holy person; saint; dervish; calender; monk
walio: nyalio (agh. hutumika kwa wingi) bits of sticks put at the bottom of a cooking pot to prevent food from sticking to the pot; wattle fence for trapping fish. wallahi! in God's name
wamba: overlay; stretch over; be overcast. () wambia; () wambika; ()wambana; () wambisha; () wambwa; be hard up; have no money.() wambia; () wambika; () wambisha; spread; be widespread. ()wambia; () wambika; () wambisha
wanda: nyanda finger width; get/become fat; become stout; look healthy. () wandia; () wandika; ()wandisha
wando: web
wanga: pain; ache: Kichwa kinani~ I have a headache. () wangia; () wangika; () wangisha; count. () wangia; ()wangika; () wangana; () wangisha; ()wangwa; practise witchcraft at night. ()wangia; () ngika; () wangisha; starch: Vyakula vya ~carbohydrates
wango: compu-tation; counting. wanguwangu hastily; apace; fast; quickly:Mara tukamwona anakuja ~ we suddenly saw him coming hastily
wania: cotest; compete; fight for; strive for: Timu za daraja la kwanza zina~ ubi-ngwa wa taifa first division teams are competing for the national championship
wanja: nyanja kohl; eye liner
waria: skilled person
wasaa: opportunity; free time; leisure time for doing sth: Sina ~ wa kufanya jambo jingine lolote I have no time for any thing else
washa: itch; irritate: Mwili una~ the body is itching. () washia; () washika; () washana; () washwa; ignite; kindle; light. ()washia; () washika; () washana; ()washwa
wasia: last directions; will
wasii: ()kabidhia; ()kabidhiana; ()kabidhiwa; () kabidhika; () kabidhisha; executor; trustee of inheritance
wasta: moderate neutral person
wazua: think deeply. (ms) Waza na ~think deeply. wee! hey!; you!
wehua: madden; drive mad. ()wehulia; () wehuka; () wehuana; ()wehusha; () wehuliwa
wembe: nyembe razor blade. (ms)Ukali wa ~ extreme sharpness
wendo: nyendo move-ment; process; step
wenga: get an allergic rash. ()wengea; () wengeka; () wengana; ()wengesha; () wengwa
wengo: curved knife
wengu: spleen
wenya: bite off with front teeth. ()ng'wenyea; () ng'wenyeka; ()ng'wenyana; () ng'wenyesha; ()ng'wenywa
wenzi: friendship; comradeship; companionship
wenzo: nyenzo lever; roller. 2 appliance
weupe: brightness; light. 2 whiteness
weusi: darkness. 2 black-ness. wewe kw (nafsi ya pili umoja) you: ~ ndiwe uliyeitwa you are the one who was called
wiche: infectiousness; contagious: Tia ~ infect; Pata wifi ~ be infected
wimbi: wave. 2 sound wave; light wave. 3 tilde. 4 escalation; bulrush millet; eleusine
wimbo: nyimbo song
winda: girdled loin-cloth tucked between legs; hunt; pursue a foe or a fugitive.() windia; () windika; () windana; () windisha
windo: booty; pray
winga: drive away; chase
wingi: wing side. (Kng); abundance; plenty. 2 plurality; (sarufi) plural
wingu: cloud: Ma~ yametandathe sky is overcast; ~ la mvua rain cloud
yonga: sway; stagger: Mwendo wake ni wa ~ she sways as she walks. () yongea; () yongeka; () yongesha
yugwa: type of white yam
yumba: sway; wave to and fro; stagger. 2 have no stand; be unstable; become infirmy. () yumbia; () yumbika; () yu-mbisha. yumkini* taz yamkini
zaana: reproduce; breed; multiply. ()zaania; () zaanika; () zaanisha
zagaa: spread. () zagalia; (tdek)zagalika; () zagaza
zaidi: more; beyond: Shati hili ni kubwa ~this shirt is bigger; ~ ya matarajio beyond expe-ctation
zaini: coax; entice; tempt; lure: Shetani alim~ Satan tempted him. 2 adore; decorate; embellish. () zainia; ()zainiana; () zainiwa; () zainika; () za inisha
zamda: type of cure for stomach ache
zeeka: get old. 2 wear out. ()zeekea; () zeekeka; () zeekesha
ziada: excess; supple-ment. 2 surplus; balance
ziaka: quiver
ziara: visit; tour; sacred place. 2 grave; tomb
zibua: unplug; uncork; clean a hole/aperture. () zibulia; (tdes) zibulisha; () zibuliwa; () zibuka; () zibuana
zidua: extract; draw out. () zidulia; (tdek) zidulika; () ziduliwa; () ziduana; () zidusha
zigia: delay; slack off. () zigilia; (tdek) zigilika; (tdes) zigilisha
zikua: uncover; unearth; expose. ()zikulia; (tdek) zi-kulika; (tdes) zikulisha; () zikuliwa; () zikuana
zimia: faint; lose zimik.a consciousness; be unconscious. () zimilia; (tdek) zimilika; () zimisha
zimua: dilute; cool. 2 warm up sth cold. () zimulia; () zimuliwa; ()zimuka; () zimusha. zimwe quenched; extingu-ished; lifeless:Makaa ~ dead coals; burnt out embers. 2 hollow coconut: Nazi ~ hollow coconut; one without kernel nor milk
zimwi: ghost; ghoul
zinaa: adultery; forni-cation:Ugonjwa wa ~ venereal disease
zinda: stand firmly; brave; dare; hold out. () zindia; () zindika; () zindisha
zinga: move about; roam. 2 turn the other way. 3 prostitute. () zingia; ()zingika; () zingisha
zinza: display goods for sale. 2 place a patient on a special diet. 3 display a thief or miscreant. (nh) ~ kichwa be stubborn. ()zinzia; () zinzika; () zi-nzisha; ()zinzwa
zirai: faint; be unco-nscious; lose consciousness. () ziraia; () ziraika; ()ziraisha
zoeza: accustom; train. ()zoeshea; () zoesheka; () zoeshana; () zoeshwa. zoevu experienced; accustomed
zoezi: exercise; practice; assignment
zomea: mock; groan aloud in derision; jeer. () zomelea; () zomeka; ()zomeana; () zomesha; () zomewa
zonga: overwhelm; overpower: Kazi zimem~ Work has overwhelmed him. () zo- zui.a ngea; () zongeka; () zo-ngana; ()zongesha; () zongwa
zongo: stomach swelling believed to be caused by jealousy/witchcraft
zubaa: be dumb-founded/nonplussed. 2 be dull/ dispirited. () zubalia; (tdek)zubalika; () zubaza
zulia: carpet
zunga: foreskin; prepuce. zunga2 uncircumcised man
zusha: start up. 2 fabricate. ()zushia; () zushiwa; () zushika; ()zushana
zuumu: resolve. () zuumia; ()zuumika; () zuumisha
zuzua: disturb; derange. 2 infatuate; craze: ji~ vaunt; flatter oneself. () zuzulia; () zuzuka; () zuzuana; () zuzusha; () zuzuliwa
